Year,Country of origin,Country of origin (ISO),Country of asylum,Country of asylum (ISO),Female 0 - 4,Female 5 - 11,Female 12 - 17,Female 18 - 59,Female 60,Female other,Female total,Male 0 - 4,Male 5 - 11,Male 12 - 17,Male 18 - 59,Male 60,Male other,Male total,Total
2001,Afghanistan,AFG,-,-,192279,304463,260994,582552,40557,6717,1387562,195602,323327,277122,785010,57395,8854,1647310,5140545
2001,Albania,ALB,-,-,0,10,0,15,0,436,461,0,11,10,22,0,653,696,11601
2001,Algeria,DZA,-,-,9,6,21,47,0,304,387,10,33,30,465,0,567,1105,11145
2001,Andorra,AND,-,-,0,0,0,0,0,0,0,0,0,0,0,0,0,0,7
2001,Angola,AGO,-,-,12267,11523,9890,27805,2117,11626,75228,11458,12171,10448,23539,1827,14743,74186,682464
2001,Antigua and Barbuda,ATG,-,-,0,0,0,0,0,0,0,0,0,0,0,0,0,0,11
2001,Egypt,EGY,-,-,5,6,5,26,0,42,84,0,0,14,109,0,65,188,6119
2001,Argentina,ARG,-,-,0,0,0,5,0,0,5,0,0,0,0,0,0,0,2110
2001,Armenia,ARM,-,-,18,43,37,164,0,257,519,28,47,41,213,5,249,583,13293
2001,Australia,AUS,-,-,0,0,0,0,0,0,0,0,0,0,0,0,0,0,10
2001,Austria,AUT,-,-,0,0,0,0,0,0,0,0,0,0,0,0,0,0,32
2001,Azerbaijan,AZE,-,-,3725,5442,4672,63562,66045,304607,448053,4018,5262,4520,55316,52140,268746,390002,847450
2001,Bahrain,BHR,-,-,0,0,0,0,0,0,0,0,0,0,5,0,0,5,51
2001,Barbados,BRB,-,-,0,0,0,0,0,0,0,0,0,0,0,0,0,0,30
2001,Burundi,BDI,-,-,36331,33599,28810,73528,3531,95120,270919,36639,34700,29760,78042,3564,77263,259968,577901
2001,Belgium,BEL,-,-,0,0,0,0,0,0,0,0,0,0,0,0,0,0,29
2001,Benin,BEN,-,-,6,0,0,0,0,0,6,0,16,0,28,0,7,51,234
2001,Bangladesh,BGD,-,-,0,0,0,10,0,77,87,7,14,0,287,0,662,970,8988
2001,Bahamas,BHS,-,-,0,0,0,0,0,0,0,0,0,0,0,0,0,0,26
2001,Bhutan,BTN,-,-,4480,9150,7842,25628,2231,5005,54336,4617,9393,8055,26361,3029,5009,56464,110909
2001,Burkina Faso,BFA,-,-,0,0,0,0,0,13,13,0,6,5,29,0,25,65,332
2001,Belarus,BLR,-,-,0,5,0,13,0,30,48,0,5,5,54,0,45,109,4822
2001,Bolivia (Plurinational State of),BOL,-,-,0,0,0,10,0,24,34,0,5,0,0,0,28,33,317
2001,Botswana,BWA,-,-,0,0,0,0,0,0,0,0,0,0,0,0,0,0,5
2001,Brazil,BRA,-,-,0,0,0,0,0,5,5,0,0,0,0,0,0,0,1045
2001,Bosnia and Herzegovina,BIH,-,-,1673,8186,7045,56792,19446,5552,98694,1669,8567,7350,41810,13089,4967,77452,889761
2001,Bulgaria,BGR,-,-,9,5,0,31,7,60,112,6,6,5,32,0,107,156,3629
2001,Belize,BLZ,-,-,0,0,0,0,0,0,0,0,0,0,0,0,0,0,30
2001,Cambodia,KHM,-,-,5,7,5,49,0,9971,10037,5,7,12,41,5,9922,9992,35060
2001,Canada,CAN,-,-,0,0,0,0,0,0,0,0,0,0,0,0,0,0,14
2001,Central African Rep.,CAF,-,-,0,18,0,73,0,43,134,5,7,6,99,0,96,213,29051
2001,Chad,TCD,-,-,185,304,264,818,5,107,1683,172,365,290,1474,186,270,2757,49274
2001,China,CHN,-,-,10,9,0,77,0,264,360,0,13,10,204,5,404,636,137186
2001,Chile,CHL,-,-,0,0,0,12,0,164,176,0,0,5,11,0,204,220,1033
2001,Cameroon,CMR,-,-,5,15,0,84,0,58,162,5,6,0,293,0,108,412,4889
2001,Congo,COG,-,-,985,1340,1189,4792,159,416,8881,913,1524,1316,6210,207,439,10609,28495
2001,Dem. Rep. of the Congo,COD,-,-,22000,24116,20683,51372,2964,28006,149141,21066,24423,20944,47549,2441,31096,147519,423857
2001,Comoros,COM,-,-,0,0,6,16,0,0,22,13,0,0,13,0,0,26,107
2001,Colombia,COL,-,-,49,118,90,260,22,209,748,48,106,111,316,21,292,894,753404
2001,Costa Rica,CRI,-,-,0,0,0,0,0,0,0,0,0,0,0,0,0,0,757
2001,Cuba,CUB,-,-,0,39,24,299,10,57,429,6,27,25,210,22,96,386,22476
2001,Cabo Verde,CPV,-,-,0,0,0,0,0,0,0,0,0,0,0,0,5,5,24
2001,Cyprus,CYP,-,-,0,0,0,0,0,0,0,0,0,0,0,0,0,0,13
2001,Czechia,CZE,-,-,7,7,0,9,0,49,72,0,8,0,8,5,72,93,1388
2001,Denmark,DNK,-,-,0,0,0,0,0,0,0,0,0,0,0,0,0,0,5
2001,Djibouti,DJI,-,-,0,0,0,0,0,23,23,0,5,0,7,0,32,44,632
2001,Dominica,DMA,-,-,0,0,0,0,0,0,0,0,0,0,0,0,0,0,28
2001,Dominican Rep.,DOM,-,-,0,0,0,0,0,0,0,0,0,0,0,0,0,0,169
2001,Ecuador,ECU,-,-,0,0,0,0,0,13,13,0,0,0,0,0,16,16,1084
2001,Equatorial Guinea,GNQ,-,-,0,5,0,5,0,13,23,6,5,5,7,0,12,35,561
2001,Eritrea,ERI,-,-,14842,13542,11595,28596,458,259,69292,13533,14647,12559,24903,344,375,66361,336071
2001,Estonia,EST,-,-,0,0,0,0,0,15,15,0,0,0,0,0,5,5,581
2001,Ethiopia,ETH,-,-,642,1486,1268,4482,90,1106,9074,570,1442,1243,7194,95,1156,11700,72705
2001,Fiji,FJI,-,-,0,0,0,0,0,0,0,0,0,0,0,0,0,0,2649
2001,Finland,FIN,-,-,0,0,0,0,0,0,0,0,0,0,0,0,0,0,5
2001,France,FRA,-,-,0,0,0,0,0,0,0,0,5,0,0,0,0,5,100
2001,Gabon,GAB,-,-,0,0,0,0,0,0,0,0,0,0,5,0,0,5,69
2001,Gambia,GMB,-,-,0,0,6,11,0,14,31,5,6,5,20,0,30,66,1033
2001,Palestinian,PSE,-,-,315,756,628,2407,156,39,4301,267,754,633,2243,188,86,4171,356047
2001,United Kingdom of Great Britain and Northern Ireland,GBR,-,-,0,0,0,0,0,0,0,0,0,0,0,0,0,0,181
2001,Georgia,GEO,-,-,3957,16333,14007,83584,28570,206,146657,4238,16245,13918,65672,18077,181,118331,287029
2001,Germany,DEU,-,-,0,0,0,0,0,7,7,0,0,0,0,0,0,0,1080
2001,Ghana,GHA,-,-,1499,1413,1206,2566,55,334,7073,1475,906,773,1404,76,485,5119,15642
2001,Guinea-Bissau,GNB,-,-,10,22,19,152,0,232,435,22,31,22,361,0,625,1061,1665
2001,Greece,GRC,-,-,0,0,0,0,0,0,0,0,0,0,0,0,0,0,142
2001,Grenada,GRD,-,-,0,0,0,0,0,0,0,0,0,0,0,0,0,0,228
2001,Guatemala,GTM,-,-,800,1477,1265,2285,273,112,6212,796,1456,1249,2712,274,133,6620,116410
2001,Guinea,GIN,-,-,0,0,5,18,0,81,104,0,55,47,144,10,235,491,5866
2001,Guyana,GUY,-,-,0,0,0,0,0,0,0,0,0,0,0,0,0,0,414
2001,Haiti,HTI,-,-,0,6,0,13,0,672,691,0,7,0,29,0,744,780,29204
2001,"China, Hong Kong SAR",HKG,-,-,0,0,0,0,0,0,0,0,0,0,0,0,0,0,23
2001,Honduras,HND,-,-,0,0,5,11,0,36,52,0,5,0,19,0,39,63,1941
2001,Croatia,HRV,-,-,3050,11747,10065,79872,32966,105,137805,3274,12340,10590,81470,22924,85,130683,314031
2001,Hungary,HUN,-,-,0,0,5,5,7,102,119,0,0,0,5,17,301,323,5101
2001,Cote d'Ivoire,CIV,-,-,0,16,10,37,0,17,80,0,6,5,82,0,30,123,1641
2001,India,IND,-,-,5,8,0,5,0,21,39,0,12,6,83,0,190,291,21308
2001,Indonesia,IDN,-,-,6,6,6,17,0,2229,2264,0,0,9,39,0,2718,2766,13572
2001,Ireland,IRL,-,-,0,0,0,0,0,0,0,0,0,0,0,0,0,0,5
2001,Iran (Islamic Rep. of),IRN,-,-,1721,2794,2440,6352,458,1330,15095,1767,2961,2560,7830,560,2122,17800,106628
2001,Iraq,IRQ,-,-,2488,20261,17390,127005,11755,1789,180688,2501,21658,18542,185983,10963,2710,242357,578334
2001,Israel,ISR,-,-,0,0,0,0,0,5,5,0,0,0,14,0,7,21,970
2001,Italy,ITA,-,-,0,0,0,0,0,5,5,0,0,0,0,0,0,0,67
2001,Jamaica,JAM,-,-,0,0,0,0,0,0,0,0,0,0,0,0,0,0,318
2001,Jordan,JOR,-,-,0,5,6,11,0,21,43,5,5,0,18,0,14,42,1330
2001,Japan,JPN,-,-,0,0,0,0,0,0,0,0,0,0,0,0,0,0,28
2001,Kazakhstan,KAZ,-,-,0,6,0,17,0,29,52,0,7,0,15,5,37,64,3679
2001,Kenya,KEN,-,-,41,14,17,76,0,12,160,24,20,19,148,0,9,220,3264
2001,Kyrgyzstan,KGZ,-,-,0,8,0,0,0,5,13,0,0,0,9,0,5,14,1080
2001,Rep. of Korea,KOR,-,-,0,0,0,0,0,0,0,0,0,0,0,0,0,0,554
2001,Dem. People's Rep. of Korea,PRK,-,-,0,0,0,0,0,0,0,0,0,0,0,0,0,0,66
2001,Kuwait,KWT,-,-,0,0,0,5,0,6,11,0,0,0,5,0,0,5,842
2001,Lao People's Dem. Rep.,LAO,-,-,0,0,7,5,0,4710,4722,5,6,5,6,0,5182,5204,13593
2001,Liberia,LBR,-,-,13089,21048,18038,39969,7648,60,99852,12340,20200,17342,34643,6747,134,91406,447076
2001,Libya,LBY,-,-,0,7,12,15,0,144,178,13,17,5,63,0,223,321,1361
2001,Saint Lucia,LCA,-,-,0,0,0,0,0,0,0,0,0,0,0,0,0,0,75
2001,Lebanon,LBN,-,-,0,0,6,7,0,58,71,0,5,0,60,0,106,171,10641
2001,Lesotho,LSO,-,-,0,0,0,0,0,0,0,0,0,0,0,0,0,0,6
2001,Sri Lanka,LKA,-,-,22,36,12,279,19,10186,10554,31,36,28,428,13,14999,15535,860848
2001,Lithuania,LTU,-,-,0,0,0,0,0,13,13,0,0,5,13,0,31,49,466
2001,Latvia,LVA,-,-,0,0,0,0,0,28,28,0,0,0,0,0,29,29,788
2001,"China, Macao SAR",MAC,-,-,0,0,0,0,0,0,0,0,0,0,0,0,0,0,10
2001,Madagascar,MDG,-,-,0,0,0,0,0,11,11,0,0,0,0,0,18,18,41
2001,Mauritania,MRT,-,-,3144,3644,3125,3989,680,287,14869,1896,3021,2591,3640,520,1547,13215,32407
2001,North Macedonia,MKD,-,-,1019,2088,1805,8080,1383,74,14449,1159,2234,1933,7255,1190,86,13857,30788
2001,Rep. of Moldova,MDA,-,-,0,0,0,13,0,45,58,0,7,0,33,0,47,87,6882
2001,Mexico,MEX,-,-,0,0,0,0,0,0,0,0,0,0,0,0,0,0,24065
2001,Mali,MLI,-,-,0,0,0,14,0,18,32,0,14,7,67,0,90,178,4178
2001,Malaysia,MYS,-,-,0,0,0,0,0,0,0,0,0,0,0,0,0,0,389
2001,Malawi,MWI,-,-,0,0,0,0,0,0,0,0,0,0,0,0,0,0,38
2001,Mongolia,MNG,-,-,0,0,0,9,0,0,9,5,0,0,10,0,0,15,907
2001,Morocco,MAR,-,-,0,0,0,5,0,42,47,0,0,0,11,0,88,99,627
2001,Mozambique,MOZ,-,-,0,0,0,0,0,5,5,0,0,0,0,0,6,6,57
2001,Malta,MLT,-,-,0,0,0,0,0,0,0,0,0,0,0,0,0,0,12
2001,Mauritius,MUS,-,-,0,0,0,5,0,0,5,0,0,0,19,0,6,25,51
2001,Myanmar,MMR,-,-,9518,12625,10811,30026,2056,53,65089,9902,13170,11285,31867,2124,167,68515,146977
2001,Namibia,NAM,-,-,107,145,123,371,37,0,783,117,157,127,1065,39,0,1505,2445
2001,Nepal,NPL,-,-,0,0,0,0,0,0,0,0,0,0,15,0,0,15,850
2001,Netherlands (Kingdom of the),NLD,-,-,0,0,0,0,0,0,0,0,0,0,0,0,0,0,92
2001,Niger,NER,-,-,0,0,0,0,0,0,0,0,0,0,7,0,10,17,893
2001,Nicaragua,NIC,-,-,14,45,31,306,24,49,469,11,34,41,307,31,51,475,17570
2001,Nigeria,NGA,-,-,33,37,26,154,0,59,309,17,57,46,513,0,141,774,10210
2001,New Zealand,NZL,-,-,0,0,0,0,0,0,0,0,0,0,0,0,0,0,5
2001,Oman,OMN,-,-,0,0,0,0,0,0,0,0,0,0,0,0,0,0,10
2001,Pakistan,PAK,-,-,0,17,0,20,0,151,188,14,19,23,652,0,286,994,20330
2001,Panama,PAN,-,-,0,0,0,0,0,0,0,0,0,0,0,0,0,0,108
2001,Paraguay,PRY,-,-,0,0,0,0,0,0,0,0,0,0,0,0,0,0,28
2001,Peru,PER,-,-,17,24,16,137,5,179,378,15,28,24,149,0,217,433,9250
2001,Philippines,PHL,-,-,0,0,0,0,0,0,0,0,0,0,0,0,0,0,47307
2001,Papua New Guinea,PNG,-,-,0,0,0,0,0,0,0,0,0,0,0,0,0,0,6
2001,Poland,POL,-,-,0,0,5,0,0,499,504,0,0,0,12,5,537,554,4066
2001,Portugal,PRT,-,-,0,0,0,0,0,0,0,0,0,0,0,0,0,0,160
2001,Qatar,QAT,-,-,0,0,0,5,0,0,5,0,0,5,6,0,0,11,29
2001,Romania,ROU,-,-,0,8,11,5,6,299,329,0,0,5,23,0,290,318,8864
2001,South Africa,ZAF,-,-,5,0,0,13,0,5,23,0,0,0,0,0,24,24,309
2001,Russian Federation,RUS,-,-,783,1291,1114,4284,271,458,8201,793,1261,1075,3453,180,415,7177,1016382
2001,Rwanda,RWA,-,-,3811,2650,2311,7097,115,2663,18647,3844,3019,2569,10538,102,3153,23225,110418
2001,El Salvador,SLV,-,-,12,152,133,893,103,364,1657,15,140,122,1047,101,391,1816,172134
2001,Saudi Arabia,SAU,-,-,0,0,0,0,0,5,5,0,0,0,0,0,0,0,176
2001,Serbia and Kosovo: S/RES/1244 (1999),SRB,-,-,8657,15563,13329,65421,17376,7864,128210,9303,16535,14165,65563,13779,9573,128918,543654
2001,Senegal,SEN,-,-,512,717,620,1956,236,13,4054,521,779,663,1432,282,53,3730,9786
2001,Seychelles,SYC,-,-,0,0,0,0,0,9,9,0,0,0,0,0,0,0,40
2001,Singapore,SGP,-,-,0,0,0,0,0,0,0,0,0,0,0,0,0,0,34
2001,Sierra Leone,SLE,-,-,8319,8262,7085,23091,3089,43,49889,7840,8723,7461,22746,2569,133,49472,188162
2001,Solomon Islands,SLB,-,-,0,0,0,0,0,0,0,0,0,0,0,0,0,0,56
2001,Somalia,SOM,-,-,16292,30880,26440,74253,5720,3974,157559,16720,32170,27591,66242,6324,4837,153884,458315
2001,Spain,ESP,-,-,0,0,0,0,0,0,0,0,0,0,0,0,0,0,63
2001,Viet Nam,VNM,-,-,5150,11468,9839,51936,11413,58960,148766,7497,12926,11097,55261,11155,66811,164747,358718
2001,Sao Tome and Principe,STP,-,-,0,0,0,0,0,0,0,0,0,0,0,0,0,0,35
2001,Sudan,SDN,-,-,31857,34335,29407,74934,3097,3820,177450,34831,44829,38417,89481,3034,7955,218547,509755
2001,Suriname,SUR,-,-,0,0,0,0,0,0,0,0,0,0,0,0,0,0,293
2001,Slovakia,SVK,-,-,0,0,0,0,0,39,39,0,0,0,6,0,39,45,863
2001,Slovenia,SVN,-,-,0,0,0,0,0,5,5,0,0,0,0,0,7,7,784
2001,Eswatini,SWZ,-,-,0,0,0,0,0,0,0,0,0,0,0,0,0,0,20
2001,Sweden,SWE,-,-,0,0,0,0,0,0,0,0,0,0,0,0,0,0,13
2001,Switzerland,CHE,-,-,0,0,0,0,0,0,0,0,0,0,0,0,0,0,60
2001,Syrian Arab Rep.,SYR,-,-,20,47,49,92,0,133,341,33,41,35,262,0,271,642,8714
2001,United Rep. of Tanzania,TZA,-,-,5,0,5,17,0,0,27,0,9,8,222,0,0,239,1176
2001,Thailand,THA,-,-,0,0,0,0,0,0,0,0,0,0,0,0,0,0,246
2001,Tajikistan,TJK,-,-,1113,627,547,1609,117,5099,9112,890,858,730,1812,131,7553,11974,56501
2001,Turkmenistan,TKM,-,-,0,0,0,8,0,7,15,0,0,0,0,0,0,0,341
2001,Timor-Leste,TLS,-,-,0,0,0,0,0,35060,35060,0,0,0,0,0,37982,37982,73062
2001,Togo,TGO,-,-,121,131,121,682,16,87,1158,112,151,116,783,13,136,1311,6321
2001,Tonga,TON,-,-,0,0,0,0,0,0,0,0,0,0,0,0,0,0,47
2001,Trinidad and Tobago,TTO,-,-,0,0,0,0,0,0,0,0,0,0,0,0,0,0,195
2001,Tunisia,TUN,-,-,0,5,0,26,0,267,298,0,5,13,104,0,565,687,1760
2001,Türkiye,TUR,-,-,901,1603,1380,2939,236,6352,13411,969,1638,1410,3474,223,10746,18460,60411
2001,Tuvalu,TUV,-,-,0,0,0,0,0,0,0,0,0,0,0,0,0,0,5
2001,United Arab Emirates,ARE,-,-,0,0,0,0,0,0,0,0,0,0,5,0,0,5,47
2001,Uganda,UGA,-,-,529,479,396,1214,26,24,2668,425,512,438,2291,31,51,3748,41076
2001,Ukraine,UKR,-,-,0,9,0,26,9,294,338,6,6,0,52,0,317,381,32608
2001,Uruguay,URY,-,-,0,0,0,0,0,0,0,0,0,0,0,0,0,0,356
2001,United States of America,USA,-,-,0,0,0,0,0,0,0,0,0,0,0,0,0,0,330
2001,Uzbekistan,UZB,-,-,0,5,0,9,0,12,26,0,0,0,10,0,13,23,11543
2001,Saint Vincent and the Grenadines,VCT,-,-,0,0,0,0,0,0,0,0,0,0,0,0,0,0,241
2001,Venezuela (Bolivarian Republic of),VEN,-,-,0,0,0,0,0,0,0,0,0,0,0,0,0,0,798
2001,Samoa,WSM,-,-,0,0,0,0,0,0,0,0,0,0,0,0,0,0,6
2001,Western Sahara,ESH,-,-,13038,15752,13501,33657,185,0,76133,13001,17254,14789,34237,917,7,80205,191913
2001,Yemen,YEM,-,-,57,148,137,355,16,18,731,69,134,115,486,10,22,836,2719
2001,Zambia,ZMB,-,-,0,9,0,17,0,0,26,5,0,0,35,0,0,40,158
2001,Zimbabwe,ZWE,-,-,0,0,0,0,0,0,0,0,0,0,16,0,11,27,2951
2001,Stateless,XXA,-,-,2500,8085,6930,37260,1595,271,56641,3008,8360,7160,41075,1340,520,61463,263825
2001,Tibetan,TIB,-,-,0,0,0,0,0,0,0,0,0,0,0,0,0,0,20721
2001,Unknown ,UNK,-,-,216,193,183,662,24,16031,17309,213,224,201,1229,30,38904,40801,1258743
2002,Afghanistan,AFG,-,-,101198,145256,124534,269181,19956,3402,663527,98766,143627,123088,201228,23496,4384,594589,3302149
2002,Albania,ALB,-,-,0,0,5,11,0,379,395,0,6,5,29,0,554,594,15744
2002,Algeria,DZA,-,-,10,16,14,63,0,246,349,27,20,13,449,0,496,1005,14462
2002,Andorra,AND,-,-,0,0,0,0,0,0,0,0,0,0,0,0,0,0,14
2002,Angola,AGO,-,-,13485,16059,13778,31074,2649,697,77742,14802,15766,13512,31433,2021,1177,78711,638415
2002,Antigua and Barbuda,ATG,-,-,0,0,0,0,0,0,0,0,0,0,0,0,0,0,46
2002,Egypt,EGY,-,-,0,10,0,21,0,35,66,5,5,5,37,0,61,113,8267
2002,Argentina,ARG,-,-,0,0,0,0,0,0,0,0,0,0,0,0,0,0,2095
2002,Armenia,ARM,-,-,19,34,35,137,0,256,481,18,43,28,169,5,231,494,18911
2002,Australia,AUS,-,-,0,0,0,0,0,0,0,0,0,0,0,0,0,0,23
2002,Austria,AUT,-,-,0,0,0,0,0,0,0,0,0,0,0,0,0,0,82
2002,Azerbaijan,AZE,-,-,18,32,39,130,24,409343,409586,0,38,47,194,11,360127,360417,842382
2002,Bahrain,BHR,-,-,0,0,0,0,0,0,0,0,0,0,5,0,0,5,54
2002,Barbados,BRB,-,-,0,0,0,0,0,0,0,0,0,0,0,0,0,0,67
2002,Burundi,BDI,-,-,38421,35510,30432,77563,3725,155026,340677,38372,36438,31268,82026,4086,117172,309362,681988
2002,Belgium,BEL,-,-,0,0,0,0,0,0,0,0,0,0,0,0,0,0,45
2002,Benin,BEN,-,-,0,0,6,0,0,0,6,0,7,0,28,0,6,41,454
2002,Bangladesh,BGD,-,-,8,0,0,10,0,98,116,0,17,5,347,0,716,1085,10631
2002,Bahamas,BHS,-,-,0,0,0,0,0,0,0,0,0,0,0,0,0,0,163
2002,Bhutan,BTN,-,-,4466,8996,7708,26626,2296,5005,55097,4812,9177,7867,27455,2871,5011,57193,112579
2002,Burkina Faso,BFA,-,-,0,0,0,0,0,6,6,0,0,0,32,0,22,54,1150
2002,Belarus,BLR,-,-,5,5,0,21,0,41,72,0,0,9,107,0,49,165,8439
2002,Bolivia (Plurinational State of),BOL,-,-,0,0,0,10,0,11,21,0,7,0,5,0,14,26,707
2002,Botswana,BWA,-,-,0,0,0,0,0,0,0,0,0,0,0,0,0,0,15
2002,Brazil,BRA,-,-,0,0,0,0,0,6,6,0,0,0,5,0,0,5,1587
2002,Bosnia and Herzegovina,BIH,-,-,3774,18103,15527,115839,41715,3423,198381,3866,18811,16117,110598,32497,3334,185223,779875
2002,Bulgaria,BGR,-,-,6,5,5,38,0,43,97,0,9,0,29,0,69,107,4588
2002,Belize,BLZ,-,-,0,0,0,0,0,0,0,0,0,0,0,0,0,0,33
2002,Cambodia,KHM,-,-,5,5,5,41,0,9280,9336,5,6,6,52,5,9065,9139,33916
2002,Canada,CAN,-,-,0,0,0,0,0,0,0,0,0,0,0,0,0,0,72
2002,Central African Rep.,CAF,-,-,1800,2217,1891,5739,88,80,11815,1342,2585,2221,7192,33,140,13513,26025
2002,Chad,TCD,-,-,272,351,300,819,15,110,1867,229,477,388,2247,42,290,3673,49776
2002,China,CHN,-,-,8,16,10,182,7,37425,37648,7,7,22,387,7,56099,56529,157323
2002,Chile,CHL,-,-,0,0,0,11,0,61,72,0,0,0,13,0,68,81,2218
2002,Cameroon,CMR,-,-,5,0,5,92,0,42,144,0,0,16,244,0,151,411,8069
2002,Congo,COG,-,-,1351,1623,1429,4869,151,599,10022,1372,1564,1340,6450,228,569,11523,35011
2002,Dem. Rep. of the Congo,COD,-,-,36352,40938,35084,81973,5382,13794,213523,34872,39973,34291,76080,4300,12004,201520,474433
2002,Comoros,COM,-,-,0,0,0,9,0,0,9,9,0,0,13,0,10,32,76
2002,Colombia,COL,-,-,174,424,375,2259,72,179,3483,209,469,416,2844,71,259,4268,1052637
2002,Costa Rica,CRI,-,-,0,0,0,0,0,0,0,0,0,0,0,0,0,0,1827
2002,Cuba,CUB,-,-,0,38,36,315,15,57,461,0,40,36,455,36,80,647,20713
2002,Cabo Verde,CPV,-,-,0,0,0,0,0,0,0,0,0,0,0,0,0,0,16
2002,Cyprus,CYP,-,-,0,0,0,0,0,0,0,0,0,0,0,0,0,0,20
2002,Czechia,CZE,-,-,0,0,7,0,0,29,36,0,0,0,0,5,35,40,7169
2002,Denmark,DNK,-,-,0,0,0,0,0,0,0,0,0,0,0,0,0,0,12
2002,Djibouti,DJI,-,-,0,5,0,20,0,18,43,0,0,6,24,0,24,54,582
2002,Dominica,DMA,-,-,0,0,0,0,0,0,0,0,0,0,0,0,0,0,53
2002,Dominican Rep.,DOM,-,-,0,0,0,0,0,0,0,0,0,0,5,0,0,5,227
2002,Ecuador,ECU,-,-,0,0,6,0,0,12,18,0,0,0,0,0,17,17,1649
2002,Equatorial Guinea,GNQ,-,-,0,14,12,33,0,11,70,0,16,5,65,5,11,102,610
2002,Eritrea,ERI,-,-,8338,11810,10126,23015,2567,19,55875,8033,12544,10746,26482,2963,15,60783,343993
2002,Estonia,EST,-,-,0,0,0,0,0,9,9,0,0,0,0,0,5,5,1215
2002,Ethiopia,ETH,-,-,492,1175,1004,3748,98,221,6738,557,1318,1137,6409,125,236,9782,70291
2002,Fiji,FJI,-,-,0,0,0,0,0,0,0,0,0,0,0,0,0,0,2573
2002,Finland,FIN,-,-,0,0,0,0,0,0,0,0,0,0,0,0,0,0,13
2002,France,FRA,-,-,0,0,0,0,0,0,0,0,0,0,5,0,0,5,165
2002,Micronesia (Federated States of),FSM,-,-,0,0,0,0,0,0,0,0,0,0,0,0,0,0,5
2002,Gabon,GAB,-,-,0,0,0,0,0,0,0,0,0,0,5,0,5,10,86
2002,Gambia,GMB,-,-,0,0,6,10,0,15,31,5,0,10,20,0,29,64,1144
2002,Palestinian,PSE,-,-,321,766,661,2482,145,30164,34539,279,807,699,2271,177,41080,45313,435774
2002,United Kingdom of Great Britain and Northern Ireland,GBR,-,-,0,0,0,0,0,0,0,0,0,0,0,0,0,0,232
2002,Georgia,GEO,-,-,6036,15813,13561,78207,25444,228,139289,6593,15684,13449,60529,15788,193,112236,284336
2002,Germany,DEU,-,-,0,0,0,0,0,0,0,0,0,0,0,0,0,0,997
2002,Ghana,GHA,-,-,1496,1414,1206,2554,55,302,7027,1473,905,778,1403,75,458,5092,16824
2002,Gibraltar,GIB,-,-,0,0,0,0,0,0,0,0,0,0,0,0,0,0,5
2002,Guinea-Bissau,GNB,-,-,0,0,0,0,0,223,223,0,0,0,30,0,619,649,1255
2002,Greece,GRC,-,-,0,0,0,0,0,0,0,0,0,5,0,0,0,5,336
2002,Grenada,GRD,-,-,0,0,0,0,0,0,0,0,0,0,0,0,0,0,447
2002,Guatemala,GTM,-,-,567,934,797,2578,205,6,5087,575,944,803,2852,201,11,5386,110004
2002,Guinea,GIN,-,-,0,7,16,10,0,99,132,0,8,7,220,0,236,471,7221
2002,Guyana,GUY,-,-,0,0,0,0,0,0,0,0,0,0,0,0,0,0,1124
2002,Haiti,HTI,-,-,0,6,0,13,0,696,715,0,7,0,19,0,874,900,29907
2002,"China, Hong Kong SAR",HKG,-,-,0,0,0,0,0,0,0,0,0,0,0,0,0,0,17
2002,Honduras,HND,-,-,0,0,15,41,0,0,56,0,5,15,43,0,0,63,1924
2002,Croatia,HRV,-,-,298,1922,1646,12528,3938,50,20382,318,2021,1737,12327,2844,48,19295,292438
2002,Hungary,HUN,-,-,0,0,0,0,11,47,58,0,0,0,5,18,90,113,6634
2002,Iceland,ISL,-,-,0,0,0,0,0,0,0,0,0,0,0,0,0,0,13
2002,Cote d'Ivoire,CIV,-,-,2519,2018,1731,4440,463,35,11206,2168,2504,2148,3862,356,76,11114,125419
2002,India,IND,-,-,0,0,0,7,0,22,29,0,0,5,69,0,184,258,25409
2002,Indonesia,IDN,-,-,27,30,26,106,0,2229,2418,28,30,26,166,5,2718,2973,15223
2002,Ireland,IRL,-,-,0,0,0,0,0,0,0,0,0,0,0,0,0,0,5
2002,Iran (Islamic Rep. of),IRN,-,-,1519,2257,1968,4909,428,1048,12129,1501,2523,2168,5624,553,1722,14091,151542
2002,Iraq,IRQ,-,-,633,2722,2307,6961,374,1735,14732,690,2897,2457,11554,356,2312,20266,465145
2002,Israel,ISR,-,-,0,0,5,0,0,0,5,0,0,0,19,0,0,19,1584
2002,Italy,ITA,-,-,0,0,0,0,0,5,5,0,0,0,0,0,0,0,259
2002,Jamaica,JAM,-,-,0,0,0,0,0,0,0,0,0,0,0,0,0,0,626
2002,Jordan,JOR,-,-,0,7,6,10,0,8,31,0,0,6,22,0,6,34,2003
2002,Japan,JPN,-,-,0,0,0,0,0,0,0,0,0,0,0,0,0,0,36
2002,Kazakhstan,KAZ,-,-,0,0,0,18,0,49,67,0,0,5,13,5,53,76,7239
2002,Kenya,KEN,-,-,29,37,27,97,0,8,198,29,29,26,163,0,0,247,13266
2002,Kyrgyzstan,KGZ,-,-,0,8,0,0,0,6,14,0,0,0,8,0,6,14,3490
2002,Rep. of Korea,KOR,-,-,0,0,0,0,0,0,0,0,0,0,0,0,0,0,848
2002,Dem. People's Rep. of Korea,PRK,-,-,0,0,0,0,0,0,0,0,0,0,0,0,0,0,326
2002,Kuwait,KWT,-,-,0,0,0,0,0,0,0,0,0,0,0,0,0,0,821
2002,Lao People's Dem. Rep.,LAO,-,-,0,0,7,5,0,4398,4410,5,6,5,6,0,4682,4704,12149
2002,Liberia,LBR,-,-,15133,20904,17904,50466,7782,46,112235,17545,22023,18884,43502,7623,102,109679,590088
2002,Libya,LBY,-,-,0,5,11,9,0,154,179,5,0,14,69,0,231,319,2365
2002,Saint Lucia,LCA,-,-,0,0,0,0,0,0,0,0,0,0,0,0,0,0,287
2002,Lebanon,LBN,-,-,0,0,5,20,0,28,53,0,14,0,49,0,68,131,28677
2002,Lesotho,LSO,-,-,0,0,0,0,0,0,0,0,0,0,0,0,0,0,10
2002,Sri Lanka,LKA,-,-,19,36,34,145,11,38317,38562,29,45,26,235,5,42564,42904,601001
2002,Lithuania,LTU,-,-,0,0,0,0,0,0,0,0,0,5,11,0,12,28,1721
2002,Latvia,LVA,-,-,0,0,0,0,0,21,21,0,0,0,5,0,19,24,3269
2002,"China, Macao SAR",MAC,-,-,0,0,0,0,0,0,0,0,0,0,0,0,0,0,21
2002,Madagascar,MDG,-,-,0,0,0,0,0,14,14,0,0,0,0,0,17,17,67
2002,Mauritania,MRT,-,-,3139,3634,3116,3921,680,362,14852,1888,2994,2572,3573,520,1781,13328,33102
2002,North Macedonia,MKD,-,-,574,904,783,3790,647,36,6734,629,1029,896,3824,614,71,7063,19664
2002,Rep. of Moldova,MDA,-,-,5,0,0,42,0,548,595,0,0,7,72,0,563,642,12641
2002,Mexico,MEX,-,-,0,0,0,0,0,0,0,0,0,0,0,0,0,0,32540
2002,Mali,MLI,-,-,0,0,0,17,0,21,38,0,10,6,51,0,94,161,4339
2002,Malaysia,MYS,-,-,0,0,0,0,0,0,0,0,0,0,0,0,0,0,597
2002,Malawi,MWI,-,-,0,0,0,0,0,0,0,0,0,0,0,0,0,0,195
2002,Mongolia,MNG,-,-,0,0,8,25,0,8,41,0,8,0,21,0,0,29,1306
2002,Morocco,MAR,-,-,0,0,0,5,0,31,36,0,0,0,6,0,71,77,1560
2002,Mozambique,MOZ,-,-,0,0,0,0,0,5,5,5,0,0,0,0,8,13,179
2002,Malta,MLT,-,-,0,0,0,0,0,0,0,0,0,0,0,0,0,0,12
2002,Mauritius,MUS,-,-,0,0,0,5,0,0,5,0,0,0,19,0,5,24,57
2002,Myanmar,MMR,-,-,9731,12490,10699,30923,2163,2092,68098,10038,13108,11230,32846,2195,3266,72683,150527
2002,Namibia,NAM,-,-,92,90,87,182,30,0,481,68,111,84,503,25,0,791,1477
2002,Nepal,NPL,-,-,0,0,0,5,0,0,5,0,0,0,26,0,0,26,1505
2002,Netherlands (Kingdom of the),NLD,-,-,0,0,0,0,0,0,0,0,0,0,0,0,0,0,119
2002,Niger,NER,-,-,0,0,0,0,0,0,0,0,0,0,23,0,9,32,1384
2002,Nicaragua,NIC,-,-,8,24,26,543,41,0,642,11,27,21,633,44,0,736,13985
2002,Nigeria,NGA,-,-,42,27,16,149,0,56,290,19,58,37,771,0,135,1020,32210
2002,Norway,NOR,-,-,0,0,0,0,0,0,0,0,0,0,0,0,0,0,5
2002,New Zealand,NZL,-,-,0,0,0,0,0,0,0,0,0,0,0,0,0,0,5
2002,Oman,OMN,-,-,0,0,0,5,0,0,5,0,0,0,0,0,0,0,24
2002,Pakistan,PAK,-,-,10,17,34,50,0,98,209,16,17,20,436,0,211,700,34535
2002,Panama,PAN,-,-,0,0,0,0,0,0,0,0,0,0,0,0,0,0,152
2002,Paraguay,PRY,-,-,0,0,0,0,0,0,0,0,0,0,0,0,0,0,70
2002,Peru,PER,-,-,10,17,15,140,5,142,329,9,22,26,162,0,191,410,10012
2002,Philippines,PHL,-,-,5,0,0,7,0,0,12,0,0,0,0,0,0,0,47625
2002,Papua New Guinea,PNG,-,-,0,0,0,0,0,0,0,0,0,0,0,0,0,0,17
2002,Poland,POL,-,-,0,0,0,8,0,146,154,0,0,0,5,5,122,132,17531
2002,Portugal,PRT,-,-,0,0,0,0,0,5,5,0,0,0,0,0,0,0,611
2002,Qatar,QAT,-,-,0,0,0,6,0,0,6,0,5,0,5,0,0,10,40
2002,Romania,ROU,-,-,0,0,10,19,6,199,234,5,0,0,11,0,188,204,11135
2002,South Africa,ZAF,-,-,5,0,0,10,0,5,20,0,0,0,0,0,13,13,453
2002,Russian Federation,RUS,-,-,595,1240,1060,3510,140,9147,15692,656,1200,1026,3150,110,6377,12519,892064
2002,Rwanda,RWA,-,-,4712,2846,2430,7600,210,1371,19169,4882,3262,2796,11349,377,1148,23814,86288
2002,El Salvador,SLV,-,-,5,121,107,1056,126,5,1420,11,101,88,1142,117,11,1470,158214
2002,Saudi Arabia,SAU,-,-,0,0,0,0,0,0,0,0,0,0,5,0,0,5,209
2002,Serbia and Kosovo: S/RES/1244 (1999),SRB,-,-,7903,16025,13740,68014,18412,3977,128071,8586,16962,14555,67605,14818,5048,127574,692330
2002,Senegal,SEN,-,-,512,718,620,1963,236,17,4066,529,782,660,1406,282,64,3723,12850
2002,Seychelles,SYC,-,-,0,0,0,0,0,7,7,0,0,0,0,0,0,0,71
2002,Singapore,SGP,-,-,0,0,0,0,0,0,0,0,0,0,0,0,0,0,60
2002,Sierra Leone,SLE,-,-,6947,6858,5898,16736,2019,44,38502,6639,6699,5711,16209,1611,142,37011,148938
2002,San Marino,SMR,-,-,0,0,0,0,0,0,0,0,0,0,0,0,0,0,5
2002,Solomon Islands,SLB,-,-,0,0,0,0,0,0,0,0,0,0,0,0,0,0,60
2002,Somalia,SOM,-,-,16772,25951,22248,69888,4172,957,139988,17828,28755,24649,74492,4271,1022,151017,448249
2002,Spain,ESP,-,-,0,0,0,0,0,0,0,0,0,0,0,0,0,0,83
2002,Viet Nam,VNM,-,-,7685,16641,14259,84537,17831,7044,147997,10792,19197,16472,92893,17313,8178,164845,377778
2002,Saint Kitts and Nevis,KNA,-,-,0,0,0,0,0,0,0,0,0,0,0,0,0,0,5
2002,Sao Tome and Principe,STP,-,-,7,0,6,6,0,0,19,0,5,0,12,0,0,17,41
2002,Sudan,SDN,-,-,39173,38752,33202,83801,3550,145,198623,40134,48259,41406,98276,3071,312,231458,522862
2002,Suriname,SUR,-,-,0,0,0,0,0,0,0,0,0,0,0,0,0,0,145
2002,Slovakia,SVK,-,-,0,0,0,5,0,45,50,0,0,6,0,0,38,44,1302
2002,Slovenia,SVN,-,-,0,0,0,0,0,0,0,0,0,0,0,0,0,0,881
2002,Eswatini,SWZ,-,-,0,0,0,0,0,0,0,0,0,0,0,0,0,0,25
2002,Sweden,SWE,-,-,0,0,0,0,0,0,0,0,0,0,0,0,0,0,42
2002,Switzerland,CHE,-,-,0,0,0,0,0,0,0,0,0,0,0,0,0,0,60
2002,Syrian Arab Rep.,SYR,-,-,20,52,45,111,0,98,326,36,57,53,230,0,212,588,23172
2002,United Rep. of Tanzania,TZA,-,-,7,0,0,14,0,0,21,7,10,10,82,0,0,109,3063
2002,Turks and Caicos Islands,TCA,-,-,0,0,0,0,0,0,0,0,0,0,0,0,0,0,5
2002,Thailand,THA,-,-,0,0,0,0,0,0,0,0,0,0,0,0,0,0,592
2002,Tajikistan,TJK,-,-,8676,3861,3315,12109,2339,1396,31696,7838,3486,2989,11259,2497,2094,30163,63481
2002,Turkmenistan,TKM,-,-,0,0,0,8,0,7,15,0,0,0,6,0,0,6,921
2002,Timor-Leste,TLS,-,-,0,0,0,0,0,0,0,0,0,0,0,0,0,0,28610
2002,Togo,TGO,-,-,129,139,117,711,16,66,1178,116,137,130,886,15,142,1426,13219
2002,Tonga,TON,-,-,0,0,0,0,0,0,0,0,0,0,0,0,0,0,72
2002,Trinidad and Tobago,TTO,-,-,0,0,0,0,0,0,0,0,0,0,0,0,0,0,356
2002,Tunisia,TUN,-,-,10,0,9,16,0,298,333,0,9,5,109,0,603,726,2975
2002,Türkiye,TUR,-,-,951,1656,1422,2830,772,5093,12724,1028,1634,1402,3180,772,9356,17372,206213
2002,Tuvalu,TUV,-,-,0,0,0,0,0,0,0,0,0,0,0,0,0,0,5
2002,United Arab Emirates,ARE,-,-,0,0,0,0,0,0,0,0,0,0,0,0,0,0,65
2002,Uganda,UGA,-,-,764,895,752,1753,154,23,4341,625,769,657,2538,103,43,4735,42444
2002,Ukraine,UKR,-,-,6,6,5,61,0,233,311,0,5,5,95,0,228,333,90130
2002,Uruguay,URY,-,-,0,0,0,0,0,0,0,0,0,0,0,0,0,0,570
2002,United States of America,USA,-,-,0,0,0,0,0,0,0,0,0,0,5,0,0,5,616
2002,Uzbekistan,UZB,-,-,0,0,5,15,0,1324,1344,0,0,6,21,0,1177,1204,10875
2002,Saint Vincent and the Grenadines,VCT,-,-,0,0,0,0,0,0,0,0,0,0,0,0,0,0,591
2002,Venezuela (Bolivarian Republic of),VEN,-,-,0,0,0,0,0,0,0,0,0,0,0,0,0,0,1304
2002,Samoa,WSM,-,-,0,0,0,0,0,0,0,0,0,0,0,0,0,0,5
2002,Western Sahara,ESH,-,-,11347,11550,9899,39019,6373,0,78188,11658,11916,10213,38898,5440,6,78131,191889
2002,Yemen,YEM,-,-,25,64,64,179,6,13,351,19,62,43,253,5,15,397,2228
2002,Zambia,ZMB,-,-,6,7,6,9,0,0,28,5,10,9,56,0,0,80,256
2002,Zimbabwe,ZWE,-,-,0,0,0,40,0,0,40,5,0,5,108,0,0,118,5182
2002,Stateless,XXA,-,-,2500,8082,6923,37213,1590,16,56324,3000,8346,7168,41058,1345,16,60933,259641
2002,Tibetan,TIB,-,-,0,0,0,0,0,0,0,0,0,0,0,0,0,0,20631
2002,Unknown ,UNK,-,-,425,384,316,1080,79,40443,42727,421,432,361,2359,73,59179,62825,566052
2003,Afghanistan,AFG,-,-,126250,163699,213321,385062,31224,2804,922360,131913,165401,223510,494186,39336,2704,1057050,2446616
2003,Albania,ALB,-,-,0,0,0,5,0,406,411,0,0,0,5,0,486,491,14908
2003,Algeria,DZA,-,-,10,5,9,20,0,299,343,20,12,0,105,0,578,715,13561
2003,Andorra,AND,-,-,0,0,0,0,0,0,0,0,0,0,0,0,0,0,12
2003,Angola,AGO,-,-,12961,14125,12135,26177,3020,711,69129,12128,14079,12076,25085,3011,1162,67541,341284
2003,Antigua and Barbuda,ATG,-,-,0,0,0,0,0,0,0,0,0,0,0,0,0,0,27
2003,Egypt,EGY,-,-,5,5,5,20,0,37,72,5,0,0,38,0,62,105,7753
2003,Argentina,ARG,-,-,0,0,0,0,0,0,0,0,0,0,0,0,0,0,1902
2003,Armenia,ARM,-,-,13,22,23,82,0,294,434,9,19,27,101,5,284,445,18123
2003,Australia,AUS,-,-,0,0,0,0,0,0,0,0,0,0,0,0,0,0,17
2003,Austria,AUT,-,-,0,0,0,0,0,0,0,0,0,0,0,0,5,5,79
2003,Azerbaijan,AZE,-,-,15,33,29,105,22,405383,405587,5,34,25,161,12,354061,354298,833490
2003,Bahrain,BHR,-,-,0,0,0,0,0,0,0,0,0,0,0,0,0,0,55
2003,Barbados,BRB,-,-,0,0,0,0,0,0,0,0,0,0,0,0,0,0,51
2003,Burundi,BDI,-,-,41078,30331,26021,64275,3193,166,165064,41058,31230,26761,68132,3655,152,170988,541643
2003,Belgium,BEL,-,-,0,0,0,0,0,0,0,0,0,0,0,0,0,0,51
2003,Benin,BEN,-,-,0,0,0,0,0,0,0,0,0,0,0,0,6,6,521
2003,Bangladesh,BGD,-,-,5,0,0,0,0,113,118,5,7,5,104,0,729,850,13835
2003,Bahamas,BHS,-,-,0,0,0,0,0,0,0,0,0,0,0,0,0,0,18
2003,Bhutan,BTN,-,-,3805,8671,7433,23962,2456,4668,50995,4051,8896,7625,24634,2997,4675,52878,114219
2003,Burkina Faso,BFA,-,-,6,0,0,0,0,6,12,0,0,0,12,0,19,31,1002
2003,Belarus,BLR,-,-,0,5,0,17,0,72,94,0,0,6,39,0,94,139,9916
2003,Bolivia (Plurinational State of),BOL,-,-,0,0,0,0,0,11,11,0,0,0,0,0,14,14,745
2003,Botswana,BWA,-,-,0,0,0,0,0,0,0,0,0,0,0,0,0,0,21
2003,Brazil,BRA,-,-,0,0,0,0,0,5,5,0,0,0,0,0,0,0,1643
2003,Bosnia and Herzegovina,BIH,-,-,3313,16018,13734,103070,37051,3121,176307,3375,16459,14118,97760,28761,3090,163563,629392
2003,Bulgaria,BGR,-,-,0,0,0,12,0,39,51,0,0,0,0,0,63,63,3938
2003,Belize,BLZ,-,-,0,0,0,0,0,0,0,0,0,0,0,0,0,0,37
2003,Cambodia,KHM,-,-,0,5,5,38,0,16596,16644,7,7,0,26,5,13765,13810,31865
2003,Canada,CAN,-,-,0,0,0,0,0,0,0,0,0,0,0,0,0,0,83
2003,Central African Rep.,CAF,-,-,16,31,45,129,10,18276,18507,26,31,25,333,5,15144,15564,36226
2003,Chad,TCD,-,-,194,326,270,773,12,129,1704,221,366,313,2109,56,409,3474,54587
2003,China,CHN,-,-,10,5,8,45,0,403,471,13,7,14,87,5,543,669,153647
2003,Chile,CHL,-,-,0,0,0,5,5,49,59,0,0,0,5,0,52,57,1858
2003,Cameroon,CMR,-,-,10,5,0,64,0,63,142,0,10,0,222,0,180,412,9557
2003,Congo,COG,-,-,1055,1571,1333,4517,157,834,9467,1120,1489,1269,6085,140,782,10885,35902
2003,Dem. Rep. of the Congo,COD,-,-,43475,44012,37741,87889,6498,3159,222774,41157,42939,36830,81092,5586,3863,211467,505407
2003,Comoros,COM,-,-,0,0,0,12,0,5,17,12,0,0,21,0,15,48,107
2003,Colombia,COL,-,-,157,313,266,753,48,219,1756,199,336,291,934,60,268,2088,1331495
2003,Costa Rica,CRI,-,-,0,0,0,0,0,0,0,0,0,0,0,0,0,0,1559
2003,Cuba,CUB,-,-,0,29,26,202,10,54,321,5,26,24,285,22,74,436,18298
2003,Cabo Verde,CPV,-,-,0,0,0,0,0,0,0,0,0,0,0,0,0,0,18
2003,Cyprus,CYP,-,-,0,0,0,0,0,0,0,0,0,0,0,0,0,0,10
2003,Czechia,CZE,-,-,0,0,0,0,0,11,11,0,0,0,0,5,17,22,7043
2003,Denmark,DNK,-,-,0,0,0,0,0,0,0,0,0,0,0,0,0,0,15
2003,Djibouti,DJI,-,-,0,5,6,19,0,21,51,0,7,7,18,0,27,59,590
2003,Dominica,DMA,-,-,0,0,0,0,0,0,0,0,0,0,0,0,0,0,41
2003,Dominican Rep.,DOM,-,-,0,0,0,0,0,0,0,0,0,0,5,0,0,5,212
2003,Ecuador,ECU,-,-,0,0,0,0,0,14,14,0,0,0,0,0,22,22,1409
2003,Equatorial Guinea,GNQ,-,-,0,16,9,27,0,13,65,0,7,17,65,5,12,106,636
2003,Eritrea,ERI,-,-,8077,10486,8991,20329,2681,22,50586,7938,11209,9600,24350,3964,16,57077,148963
2003,Estonia,EST,-,-,0,0,0,0,0,7,7,0,0,0,0,0,5,5,1198
2003,Ethiopia,ETH,-,-,532,1276,1100,4326,97,219,7550,613,1345,1186,7179,128,240,10691,73479
2003,Fiji,FJI,-,-,0,0,0,0,0,0,0,0,0,0,0,0,0,0,2106
2003,Finland,FIN,-,-,0,0,0,0,0,0,0,0,0,0,0,0,0,0,11
2003,France,FRA,-,-,0,0,0,0,0,0,0,0,0,0,0,0,5,5,176
2003,Micronesia (Federated States of),FSM,-,-,0,0,0,0,0,0,0,0,0,0,0,0,0,0,5
2003,Gabon,GAB,-,-,0,0,0,0,0,0,0,0,0,0,0,0,0,0,71
2003,Gambia,GMB,-,-,0,5,6,7,0,16,34,5,6,0,22,0,36,69,1085
2003,Palestinian,PSE,-,-,1220,2462,2124,8492,854,29,15181,1196,2587,2197,8605,848,67,15500,357636
2003,United Kingdom of Great Britain and Northern Ireland,GBR,-,-,0,0,0,0,0,0,0,0,0,0,0,0,0,0,210
2003,Georgia,GEO,-,-,5878,15856,13598,82590,26171,339,144432,6497,15864,13594,64232,16218,326,116731,278617
2003,Germany,DEU,-,-,0,0,0,0,0,5,5,0,0,0,0,0,5,5,780
2003,Ghana,GHA,-,-,1496,1414,1212,2568,55,266,7011,1473,905,778,1409,75,418,5058,17528
2003,Guinea-Bissau,GNB,-,-,7,6,0,27,0,220,260,11,6,5,41,0,611,674,1193
2003,Greece,GRC,-,-,0,0,0,0,0,0,0,0,0,0,0,0,0,0,305
2003,Grenada,GRD,-,-,0,0,0,0,0,0,0,0,0,0,0,0,0,0,334
2003,Guatemala,GTM,-,-,7,55,48,1270,297,5,1682,20,62,54,1826,266,11,2239,95278
2003,Guinea,GIN,-,-,5,12,8,24,0,138,187,0,9,0,56,0,282,347,7029
2003,Guyana,GUY,-,-,0,0,0,0,0,0,0,0,0,0,0,0,0,0,1371
2003,Haiti,HTI,-,-,0,6,0,0,0,714,720,0,7,0,27,0,947,981,25902
2003,"China, Hong Kong SAR",HKG,-,-,0,0,0,0,0,0,0,0,0,0,0,0,0,0,27
2003,Honduras,HND,-,-,5,7,6,33,0,0,51,0,12,7,42,0,0,61,1808
2003,Croatia,HRV,-,-,174,1665,1429,10246,2981,49,16544,199,1729,1488,10266,2255,44,15981,243223
2003,Hungary,HUN,-,-,0,0,0,0,11,41,52,0,0,0,5,18,70,93,4399
2003,Iceland,ISL,-,-,0,0,0,0,0,0,0,0,0,0,0,0,0,0,16
2003,Cote d'Ivoire,CIV,-,-,999,839,730,1686,36,1844,6134,926,921,785,2201,49,1938,6820,74958
2003,India,IND,-,-,0,0,0,0,0,23,23,0,0,0,71,0,175,246,25159
2003,Indonesia,IDN,-,-,242,278,240,1036,52,2400,4248,251,325,279,3239,54,2600,6748,39934
2003,Ireland,IRL,-,-,0,0,0,0,0,0,0,0,0,0,0,0,0,0,16
2003,Iran (Islamic Rep. of),IRN,-,-,421,1278,1122,3789,242,967,7819,462,1473,1267,4862,329,1557,9950,133889
2003,Iraq,IRQ,-,-,708,2799,3143,8938,539,1653,17780,725,3012,3398,13237,544,2103,23019,418644
2003,Israel,ISR,-,-,0,0,0,0,0,0,0,0,0,0,21,0,5,26,1570
2003,Italy,ITA,-,-,0,0,0,0,0,0,0,0,0,0,0,0,0,0,238
2003,Jamaica,JAM,-,-,0,0,0,0,0,0,0,0,0,0,0,0,0,0,670
2003,Jordan,JOR,-,-,0,0,12,5,0,5,22,0,5,0,11,0,11,27,1866
2003,Japan,JPN,-,-,0,0,0,0,0,0,0,0,0,0,0,0,0,0,44
2003,Kazakhstan,KAZ,-,-,0,0,0,12,0,71,83,0,6,0,5,5,66,82,7451
2003,Kenya,KEN,-,-,13,37,27,83,0,5,165,20,20,13,106,0,6,165,14026
2003,Kyrgyzstan,KGZ,-,-,0,5,0,0,0,12,17,0,5,0,5,0,13,23,3758
2003,Kiribati,KIR,-,-,0,0,0,0,0,0,0,0,0,0,0,0,0,0,15
2003,Rep. of Korea,KOR,-,-,0,0,0,0,0,0,0,0,0,0,0,0,0,0,735
2003,Dem. People's Rep. of Korea,PRK,-,-,0,0,0,0,0,0,0,0,0,0,0,0,0,0,347
2003,Kuwait,KWT,-,-,0,0,0,0,0,0,0,0,0,12,0,0,0,12,719
2003,Lao People's Dem. Rep.,LAO,-,-,0,0,8,5,0,3971,3984,0,8,7,7,0,4246,4268,10839
2003,Liberia,LBR,-,-,25565,28819,24683,71326,10136,357,160886,27979,29436,25203,59918,5925,3555,152016,891142
2003,Libya,LBY,-,-,0,0,6,0,0,171,177,0,0,0,0,0,241,241,2451
2003,Saint Lucia,LCA,-,-,0,0,0,0,0,0,0,0,0,0,0,0,0,0,288
2003,Lebanon,LBN,-,-,0,0,0,9,0,28,37,0,10,0,28,0,66,104,27058
2003,Lesotho,LSO,-,-,0,0,0,0,0,0,0,0,0,0,0,0,0,0,10
2003,Sri Lanka,LKA,-,-,13221,28125,24103,116433,13347,5874,201103,13650,29340,25151,109253,13806,9715,200915,511075
2003,Lithuania,LTU,-,-,0,0,0,0,0,0,0,0,0,0,0,0,11,11,1893
2003,Latvia,LVA,-,-,0,0,0,0,0,23,23,0,0,0,0,0,18,18,3371
2003,"China, Macao SAR",MAC,-,-,0,0,0,0,0,0,0,0,0,0,0,0,0,0,18
2003,Madagascar,MDG,-,-,0,0,0,0,0,29,29,0,0,0,0,0,30,30,115
2003,Mauritania,MRT,-,-,3163,3654,3129,3959,685,427,15017,1923,3013,2589,3574,525,2336,13960,33390
2003,North Macedonia,MKD,-,-,95,134,113,382,35,55,814,107,145,135,302,70,73,832,7152
2003,Rep. of Moldova,MDA,-,-,0,0,0,11,0,64,75,0,0,0,11,0,80,91,12119
2003,Mexico,MEX,-,-,0,0,0,0,0,0,0,0,0,0,0,0,0,0,28110
2003,Mali,MLI,-,-,0,0,0,9,0,1880,1889,0,10,6,0,0,1728,1744,4178
2003,Malaysia,MYS,-,-,0,0,0,0,0,0,0,0,0,0,0,0,0,0,560
2003,Malawi,MWI,-,-,0,0,0,0,0,0,0,0,0,0,0,0,0,0,1510
2003,Mongolia,MNG,-,-,0,0,0,6,0,10,16,0,0,0,0,0,8,8,1017
2003,Morocco,MAR,-,-,0,0,0,0,0,27,27,0,0,0,6,0,63,69,1554
2003,Mozambique,MOZ,-,-,0,0,0,0,0,5,5,0,0,0,0,0,8,8,274
2003,Malta,MLT,-,-,0,0,0,0,0,0,0,0,0,0,0,0,0,0,14
2003,Mauritius,MUS,-,-,0,0,0,5,0,0,5,0,0,0,42,0,0,42,73
2003,Myanmar,MMR,-,-,9309,13003,11140,33235,2328,95,69110,9806,13552,11622,37404,2398,266,75048,166786
2003,Namibia,NAM,-,-,0,0,5,17,0,0,22,0,5,0,8,5,0,18,1474
2003,Nepal,NPL,-,-,0,0,0,0,0,0,0,0,0,0,6,0,8,14,1957
2003,Netherlands (Kingdom of the),NLD,-,-,0,0,0,0,0,0,0,0,0,0,0,0,0,0,128
2003,Niger,NER,-,-,0,0,0,0,0,0,0,0,0,0,10,0,8,18,1168
2003,Nicaragua,NIC,-,-,5,20,13,340,30,107,515,10,20,15,327,38,123,533,10839
2003,Nigeria,NGA,-,-,1002,2208,1881,3887,160,68,9206,1100,2127,1807,3309,311,132,8786,39061
2003,Norway,NOR,-,-,0,0,0,0,0,0,0,0,0,0,0,0,0,0,5
2003,Nauru,NRU,-,-,0,0,0,0,0,0,0,0,0,0,0,0,0,0,5
2003,New Zealand,NZL,-,-,0,0,0,0,0,0,0,0,0,0,0,0,0,0,5
2003,Oman,OMN,-,-,0,0,0,0,0,0,0,0,0,0,0,0,0,0,5
2003,Pakistan,PAK,-,-,9,15,17,24,0,87,152,7,16,0,295,0,186,504,41229
2003,Panama,PAN,-,-,0,0,0,0,0,0,0,0,0,0,0,0,0,0,118
2003,Paraguay,PRY,-,-,0,0,0,0,0,0,0,0,0,0,0,0,0,0,84
2003,Peru,PER,-,-,0,5,0,27,0,124,156,0,8,6,24,0,163,201,8347
2003,Philippines,PHL,-,-,0,0,0,0,0,0,0,0,0,0,7,0,0,7,59438
2003,Papua New Guinea,PNG,-,-,0,0,0,0,0,0,0,0,0,0,0,0,0,0,18
2003,Poland,POL,-,-,0,0,0,0,0,116,116,0,0,0,5,5,101,111,16115
2003,Portugal,PRT,-,-,0,0,0,0,0,0,0,0,0,0,0,0,5,5,446
2003,Qatar,QAT,-,-,0,0,0,0,0,0,0,0,0,0,0,0,0,0,28
2003,Romania,ROU,-,-,0,0,0,5,6,154,165,0,0,0,0,0,152,152,10548
2003,South Africa,ZAF,-,-,5,0,0,5,0,5,15,0,0,0,0,0,11,11,558
2003,Russian Federation,RUS,-,-,806,1061,892,3323,191,9858,16131,870,1293,1112,3567,101,7080,14023,776354
2003,Rwanda,RWA,-,-,5378,2917,2531,8145,254,883,20108,5489,3380,2881,12961,401,695,25807,85401
2003,El Salvador,SLV,-,-,52,184,160,963,118,5,1482,46,176,152,1100,127,10,1611,134313
2003,Saudi Arabia,SAU,-,-,0,0,0,0,0,0,0,0,0,0,9,0,0,9,331
2003,Serbia and Kosovo: S/RES/1244 (1999),SRB,-,-,4319,14976,12839,63140,18015,3962,117251,4720,15969,13692,62703,14491,4943,116518,647696
2003,Senegal,SEN,-,-,524,701,599,2080,257,27,4188,537,751,642,1470,309,74,3783,9178
2003,Seychelles,SYC,-,-,0,0,0,5,0,6,11,0,0,0,0,0,0,0,50
2003,Singapore,SGP,-,-,0,0,0,0,0,0,0,0,0,0,0,0,0,0,55
2003,Sierra Leone,SLE,-,-,2849,3302,2831,9240,1301,665,20188,4780,4215,3617,8722,691,741,22766,77478
2003,Solomon Islands,SLB,-,-,0,0,0,0,0,0,0,0,0,0,0,0,0,0,76
2003,Somalia,SOM,-,-,15143,23280,19945,58939,3944,408,121659,16168,25885,22182,57037,4070,441,125783,419101
2003,Spain,ESP,-,-,0,0,0,0,0,0,0,0,0,0,0,0,0,0,91
2003,Viet Nam,VNM,-,-,8072,17023,14606,84398,18464,6026,148589,11197,19424,16676,92028,17606,7290,164221,366108
2003,Saint Kitts and Nevis,KNA,-,-,0,0,0,0,0,0,0,0,0,0,0,0,0,0,5
2003,Sao Tome and Principe,STP,-,-,0,6,6,7,0,0,19,0,0,5,12,0,0,17,41
2003,Sudan,SDN,-,-,35790,34467,29537,77297,3179,62834,243104,38278,43819,37571,94042,2611,47617,263938,612905
2003,Suriname,SUR,-,-,0,0,0,0,0,0,0,0,0,0,0,0,0,0,100
2003,Slovakia,SVK,-,-,0,0,5,0,0,50,55,0,0,0,0,0,41,41,1070
2003,Slovenia,SVN,-,-,0,0,0,0,0,0,0,0,0,0,0,0,0,0,633
2003,Eswatini,SWZ,-,-,0,0,0,0,0,0,0,0,0,0,0,0,0,0,10
2003,Sweden,SWE,-,-,0,0,0,0,0,0,0,0,0,0,0,0,0,0,59
2003,Switzerland,CHE,-,-,0,0,0,0,0,0,0,0,0,0,0,0,0,0,34
2003,Syrian Arab Rep.,SYR,-,-,41,60,58,243,31,93,526,27,72,66,352,50,213,780,24364
2003,United Rep. of Tanzania,TZA,-,-,7,0,0,14,0,0,21,7,10,10,84,0,0,111,4265
2003,Turks and Caicos Islands,TCA,-,-,0,0,0,0,0,0,0,0,0,0,0,0,0,0,5
2003,Thailand,THA,-,-,0,0,0,0,0,0,0,0,0,0,0,0,0,0,450
2003,Tajikistan,TJK,-,-,8076,3477,2976,10162,2239,2252,29182,7193,3082,2647,9176,2384,2690,27172,59135
2003,Turkmenistan,TKM,-,-,0,0,0,8,0,7,15,0,0,0,6,0,0,6,995
2003,Timor-Leste,TLS,-,-,0,0,0,0,0,0,0,0,0,0,0,0,0,0,969
2003,Togo,TGO,-,-,241,368,316,1398,25,85,2433,286,377,343,2196,39,206,3447,16330
2003,Tonga,TON,-,-,0,0,0,0,0,0,0,0,0,0,0,0,0,0,49
2003,Trinidad and Tobago,TTO,-,-,0,0,0,0,0,0,0,0,0,0,0,0,0,0,327
2003,Tunisia,TUN,-,-,5,0,0,9,0,308,322,10,0,0,28,0,646,684,2932
2003,Türkiye,TUR,-,-,477,1513,1287,3090,287,4810,11464,555,1579,1366,2824,258,9091,15673,193613
2003,Tuvalu,TUV,-,-,0,0,0,0,0,0,0,0,0,0,0,0,0,0,5
2003,United Arab Emirates,ARE,-,-,0,0,0,0,0,0,0,0,0,0,0,0,0,0,38
2003,Uganda,UGA,-,-,609,642,552,1441,77,25,3346,501,591,521,2334,59,41,4047,38058
2003,Ukraine,UKR,-,-,0,0,0,10,0,281,291,0,0,0,15,0,254,269,96991
2003,Uruguay,URY,-,-,0,0,0,0,0,0,0,0,0,0,0,0,0,0,600
2003,United States of America,USA,-,-,0,0,0,0,0,0,0,0,0,0,0,0,0,0,739
2003,Uzbekistan,UZB,-,-,0,0,0,16,0,262,278,0,0,5,20,0,231,256,9348
2003,Saint Vincent and the Grenadines,VCT,-,-,0,0,0,0,0,0,0,0,0,0,0,0,0,0,524
2003,Venezuela (Bolivarian Republic of),VEN,-,-,0,0,5,0,0,0,5,0,0,0,15,0,0,15,2614
2003,Western Sahara,ESH,-,-,14538,14856,12734,23713,10271,13780,89892,14502,16360,14024,24879,10274,12228,92267,191748
2003,Yemen,YEM,-,-,14,36,45,129,5,22,251,7,38,32,167,6,25,275,2062
2003,Zambia,ZMB,-,-,10,11,15,14,0,0,50,8,17,15,80,0,0,120,355
2003,Zimbabwe,ZWE,-,-,0,0,0,47,0,0,47,0,0,0,116,0,0,116,10625
2003,Stateless,XXA,-,-,2500,8082,6923,20220,1590,225,39540,3000,8346,7159,21071,1335,483,41394,223940
2003,Tibetan,TIB,-,-,0,0,0,0,0,0,0,0,0,0,0,0,0,0,20742
2003,Unknown ,UNK,-,-,472,344,289,997,54,15742,17898,439,951,810,2892,75,39770,44937,573161
2004,Afghanistan,AFG,-,-,110737,157553,236182,401876,32141,456,938945,111036,160531,248601,436368,37697,571,994804,2691054
2004,Albania,ALB,-,-,0,5,6,20,5,43,79,5,7,6,31,0,29,78,13793
2004,Algeria,DZA,-,-,18,18,32,85,0,57,210,21,22,14,233,0,92,382,11985
2004,Andorra,AND,-,-,0,0,0,0,0,0,0,0,0,0,0,0,0,0,5
2004,Angola,AGO,-,-,7184,8216,7080,14607,1459,25000,63546,7694,7629,6555,14663,1421,24036,61998,238382
2004,Antigua and Barbuda,ATG,-,-,0,0,0,0,0,0,0,0,0,0,0,0,0,0,26
2004,Egypt,EGY,-,-,0,6,6,23,0,8,43,0,12,0,69,0,24,105,7603
2004,Argentina,ARG,-,-,0,0,0,7,0,0,7,0,0,0,0,0,0,0,1289
2004,Armenia,ARM,-,-,9,36,28,119,5,5,202,12,37,29,164,5,5,252,17453
2004,Australia,AUS,-,-,0,0,0,0,0,0,0,0,0,0,0,0,0,0,18
2004,Austria,AUT,-,-,0,0,0,0,0,0,0,0,0,0,0,0,0,0,49
2004,Azerbaijan,AZE,-,-,10,30,28,108,24,403585,403785,5,26,25,149,11,358701,358917,833080
2004,Bahrain,BHR,-,-,0,0,0,0,0,0,0,0,0,0,0,0,0,0,70
2004,Barbados,BRB,-,-,0,0,0,0,0,0,0,0,0,0,0,0,0,0,22
2004,Burundi,BDI,-,-,27158,23489,20140,54612,1881,249,127529,27203,24000,20573,56133,2255,265,130429,494460
2004,Belgium,BEL,-,-,0,0,0,0,0,0,0,0,0,0,0,0,0,0,58
2004,Benin,BEN,-,-,0,0,0,5,0,0,5,0,0,0,13,0,0,13,510
2004,Bangladesh,BGD,-,-,0,0,0,24,0,0,24,10,10,10,395,0,12,437,15072
2004,Bahamas,BHS,-,-,0,0,0,0,0,0,0,0,0,0,0,0,0,0,19
2004,Bhutan,BTN,-,-,4112,8546,7325,28596,2780,5020,56379,4352,8771,7518,29448,3447,5000,58536,115741
2004,Burkina Faso,BFA,-,-,0,0,0,0,0,0,0,0,0,0,34,0,0,34,687
2004,Belarus,BLR,-,-,5,5,0,7,0,0,17,0,0,6,29,0,0,35,9629
2004,Bolivia (Plurinational State of),BOL,-,-,0,0,0,6,0,0,6,0,0,0,5,0,0,5,660
2004,Botswana,BWA,-,-,0,0,0,0,0,0,0,0,0,0,0,0,0,0,12
2004,Brazil,BRA,-,-,0,0,0,0,0,6,6,0,0,0,0,0,0,0,1412
2004,Bosnia and Herzegovina,BIH,-,-,3156,15148,12984,97581,34856,2330,166055,3225,15566,13359,92518,27035,2190,153893,539237
2004,Bulgaria,BGR,-,-,5,7,7,46,0,6,71,0,5,6,34,0,6,51,3449
2004,Belize,BLZ,-,-,0,0,0,0,0,0,0,0,0,0,0,0,0,0,29
2004,Cambodia,KHM,-,-,6,19,19,101,5,1539,1689,0,19,18,113,10,1503,1663,18610
2004,Canada,CAN,-,-,0,0,0,0,0,0,0,0,0,0,0,0,0,0,75
2004,Central African Rep.,CAF,-,-,3633,3024,2589,6093,224,72,15635,3455,2792,2405,5443,314,64,14473,32342
2004,Chad,TCD,-,-,184,355,322,958,12,21,1852,261,444,363,2444,67,10,3589,55185
2004,China,CHN,-,-,25,26,5,205,0,251,512,33,5,10,426,0,308,782,154433
2004,Chile,CHL,-,-,0,0,5,5,0,12,22,0,8,0,14,0,11,33,1380
2004,Cameroon,CMR,-,-,10,10,0,125,0,6,151,0,5,11,277,0,18,311,11353
2004,Congo,COG,-,-,871,1427,1210,4270,167,437,8382,900,1421,1211,6002,191,385,10110,35281
2004,Dem. Rep. of the Congo,COD,-,-,35818,37207,31858,77723,4901,35177,222684,35301,38060,32628,69871,4069,30865,210794,513097
2004,Comoros,COM,-,-,0,5,0,0,0,0,5,0,0,0,15,0,0,15,569
2004,Colombia,COL,-,-,375,951,837,3737,161,798636,804697,453,918,781,5147,227,767326,774852,2095255
2004,Costa Rica,CRI,-,-,0,0,0,0,0,0,0,0,0,0,0,0,0,0,487
2004,Cuba,CUB,-,-,10,48,27,346,25,21,477,5,27,34,656,27,19,768,17656
2004,Cabo Verde,CPV,-,-,0,0,0,0,0,0,0,0,0,0,0,0,0,0,16
2004,Czechia,CZE,-,-,0,0,0,0,0,0,0,0,0,0,5,5,0,10,4695
2004,Denmark,DNK,-,-,0,0,0,0,0,0,0,0,0,0,0,0,0,0,15
2004,Djibouti,DJI,-,-,8,0,0,17,0,0,25,7,0,0,26,0,0,33,528
2004,Dominica,DMA,-,-,0,0,0,0,0,0,0,0,0,0,0,0,0,0,41
2004,Dominican Rep.,DOM,-,-,0,5,0,6,0,0,11,0,0,0,5,0,0,5,239
2004,Ecuador,ECU,-,-,0,5,0,5,0,0,10,0,0,0,10,0,9,19,1210
2004,Equatorial Guinea,GNQ,-,-,0,10,15,28,0,0,53,0,7,17,74,5,0,103,590
2004,Eritrea,ERI,-,-,420,535,466,1545,144,17447,20557,453,648,554,3625,195,26335,31810,171335
2004,Estonia,EST,-,-,0,0,0,0,0,0,0,0,0,0,5,0,0,5,992
2004,Ethiopia,ETH,-,-,775,1711,1465,3638,57,6568,14214,953,3310,2811,5381,121,7325,19901,76251
2004,Fiji,FJI,-,-,0,0,0,0,0,0,0,0,0,0,0,0,0,0,1800
2004,Finland,FIN,-,-,0,0,0,0,0,0,0,0,0,0,0,0,0,0,5
2004,France,FRA,-,-,0,0,0,0,0,0,0,0,0,0,5,0,0,5,167
2004,Micronesia (Federated States of),FSM,-,-,0,0,0,0,0,0,0,0,0,0,0,0,0,0,5
2004,Gabon,GAB,-,-,0,0,0,0,0,0,0,0,0,0,0,0,0,0,76
2004,Gambia,GMB,-,-,0,0,0,26,0,5,31,0,5,0,44,0,6,55,1123
2004,Palestinian,PSE,-,-,1661,3175,2739,10388,1017,79207,98187,1678,3458,2948,11456,944,160820,181304,356851
2004,United Kingdom of Great Britain and Northern Ireland,GBR,-,-,0,0,0,0,0,0,0,0,0,0,0,0,0,0,187
2004,Georgia,GEO,-,-,6019,14039,12038,74742,23942,5,130785,6643,14078,12059,59268,14634,10,106692,249281
2004,Germany,DEU,-,-,0,0,0,0,0,0,0,0,0,0,0,0,0,0,135
2004,Ghana,GHA,-,-,8,12,5,39,5,0,69,6,16,15,94,7,0,138,16409
2004,Guinea-Bissau,GNB,-,-,6,0,0,29,0,0,35,5,0,7,105,0,5,122,1207
2004,Greece,GRC,-,-,0,0,0,5,0,0,5,0,0,0,0,0,0,0,253
2004,Grenada,GRD,-,-,0,0,0,0,0,0,0,0,0,0,0,0,0,0,219
2004,Guatemala,GTM,-,-,5,31,27,840,62,0,965,14,52,44,1287,54,0,1451,63016
2004,Guinea,GIN,-,-,5,7,13,60,0,10,95,0,13,26,141,0,6,186,7256
2004,Guyana,GUY,-,-,0,0,0,5,0,0,5,0,0,0,0,0,0,0,859
2004,Haiti,HTI,-,-,0,6,0,14,0,0,20,0,0,0,77,0,0,77,25475
2004,"China, Hong Kong SAR",HKG,-,-,0,0,0,0,0,0,0,0,0,0,0,0,0,0,17
2004,Honduras,HND,-,-,7,0,0,23,0,0,30,5,0,5,32,0,0,42,1750
2004,Croatia,HRV,-,-,157,1266,1077,8932,2308,18,13758,183,1351,1159,8903,1803,15,13414,223375
2004,Hungary,HUN,-,-,0,0,0,0,6,14,20,0,0,0,5,18,14,37,3344
2004,Iceland,ISL,-,-,0,0,0,0,0,0,0,0,0,0,0,0,0,0,14
2004,Cote d'Ivoire,CIV,-,-,622,1027,876,2114,107,7,4753,579,1177,1023,3856,91,8,6734,66430
2004,India,IND,-,-,5,0,5,17,0,8,35,5,0,0,119,0,13,137,25043
2004,Indonesia,IDN,-,-,668,348,303,3064,64,2400,6847,696,436,370,12247,87,2600,16436,49866
2004,Ireland,IRL,-,-,0,0,0,0,0,0,0,0,0,0,0,0,0,0,10
2004,Iran (Islamic Rep. of),IRN,-,-,210,586,480,2335,103,351,4065,250,694,576,3616,131,490,5757,124690
2004,Iraq,IRQ,-,-,4053,7595,15596,30732,2435,1081,61492,4318,8352,16870,50035,2486,1319,83380,358647
2004,Israel,ISR,-,-,0,0,0,0,0,0,0,0,0,0,21,0,0,21,1429
2004,Italy,ITA,-,-,0,0,0,0,0,0,0,0,0,0,0,0,0,0,215
2004,Jamaica,JAM,-,-,0,0,0,0,0,0,0,0,0,0,0,0,0,0,635
2004,Jordan,JOR,-,-,5,7,14,7,0,0,33,12,0,0,42,0,5,59,1861
2004,Japan,JPN,-,-,0,0,0,0,0,0,0,0,0,0,0,0,0,0,89
2004,Kazakhstan,KAZ,-,-,0,5,5,17,0,5,32,0,5,5,89,0,5,104,6780
2004,Kenya,KEN,-,-,0,5,0,28,0,0,33,15,0,6,26,0,0,47,15051
2004,Kyrgyzstan,KGZ,-,-,0,6,0,7,0,0,13,0,20,5,0,0,0,25,3760
2004,Kiribati,KIR,-,-,0,0,0,0,0,0,0,0,0,0,0,0,0,0,31
2004,Rep. of Korea,KOR,-,-,0,0,0,0,0,0,0,0,0,0,0,0,0,0,576
2004,Dem. People's Rep. of Korea,PRK,-,-,0,0,0,9,0,0,9,0,0,0,16,0,0,16,408
2004,Kuwait,KWT,-,-,0,0,0,0,0,0,0,0,0,5,5,0,0,10,480
2004,Lao People's Dem. Rep.,LAO,-,-,16,24,21,550,5,92,708,30,26,24,755,23,123,981,16590
2004,Liberia,LBR,-,-,22450,32087,27514,68583,6447,7,157088,25305,32166,27578,62224,5646,5,152924,841619
2004,Libya,LBY,-,-,0,0,11,5,0,176,192,0,0,5,18,0,230,253,2507
2004,Saint Lucia,LCA,-,-,0,0,0,0,0,0,0,0,0,0,0,0,0,0,181
2004,Lebanon,LBN,-,-,0,5,5,38,0,5,53,5,11,10,48,0,12,86,21464
2004,Lesotho,LSO,-,-,0,0,0,0,0,0,0,0,0,0,0,0,0,0,15
2004,Sri Lanka,LKA,-,-,12086,25664,21991,107063,12445,206,179455,12501,26795,22971,100825,12790,318,176200,469048
2004,Lithuania,LTU,-,-,0,0,0,0,0,0,0,0,0,0,0,0,0,0,1672
2004,Latvia,LVA,-,-,0,0,0,0,0,0,0,0,0,0,5,0,0,5,2970
2004,"China, Macao SAR",MAC,-,-,0,0,0,0,0,0,0,0,5,0,5,0,0,10,23
2004,Madagascar,MDG,-,-,0,0,0,0,0,0,0,0,0,0,6,0,0,6,146
2004,Mauritania,MRT,-,-,3161,3650,3130,3955,680,0,14576,1918,3011,2582,3600,520,0,11631,33677
2004,North Macedonia,MKD,-,-,64,85,67,253,25,20,514,60,91,90,188,39,39,507,5801
2004,Rep. of Moldova,MDA,-,-,0,0,0,22,0,0,22,0,0,0,20,0,7,27,12551
2004,Maldives,MDV,-,-,0,0,0,0,0,0,0,0,0,0,5,0,0,5,5
2004,Mexico,MEX,-,-,0,0,0,0,0,0,0,0,0,0,0,0,0,0,20571
2004,Mali,MLI,-,-,0,0,0,13,0,1855,1868,0,5,0,22,0,1645,1672,4167
2004,Malaysia,MYS,-,-,0,0,0,0,0,0,0,0,0,0,0,0,0,0,462
2004,Malawi,MWI,-,-,0,0,0,0,0,0,0,0,0,0,7,0,0,7,3032
2004,Mongolia,MNG,-,-,0,0,6,12,0,0,18,0,0,5,14,0,0,19,1004
2004,Morocco,MAR,-,-,0,0,0,11,0,6,17,7,0,0,20,0,7,34,1564
2004,Mozambique,MOZ,-,-,0,0,0,0,0,0,0,5,0,0,0,0,0,5,404
2004,Malta,MLT,-,-,0,0,0,0,0,0,0,0,0,0,0,0,0,0,5
2004,Mauritius,MUS,-,-,0,0,0,0,0,0,0,0,0,0,0,0,0,0,26
2004,Myanmar,MMR,-,-,9949,13729,11766,36245,2474,73,74236,10510,14273,12241,47595,2601,210,87430,172505
2004,Namibia,NAM,-,-,0,5,0,0,0,0,5,0,5,0,0,0,0,5,1491
2004,Nepal,NPL,-,-,0,0,0,5,0,0,5,0,0,0,90,0,0,90,2723
2004,Netherlands (Kingdom of the),NLD,-,-,0,0,0,0,0,0,0,0,0,0,0,0,0,0,160
2004,Niger,NER,-,-,0,0,0,0,0,0,0,0,0,0,17,0,0,17,1027
2004,Nicaragua,NIC,-,-,5,13,13,370,25,0,426,5,11,10,350,45,0,421,8065
2004,Nigeria,NGA,-,-,1093,2150,1840,3936,153,0,9172,1204,2009,1725,3358,283,0,8579,37136
2004,Norway,NOR,-,-,0,0,0,0,0,0,0,0,0,0,0,0,0,0,10
2004,New Zealand,NZL,-,-,0,0,0,0,0,0,0,0,0,0,0,0,0,0,5
2004,Oman,OMN,-,-,0,0,0,0,0,0,0,0,0,0,0,0,0,0,16
2004,Pakistan,PAK,-,-,33,32,39,114,0,36,254,25,42,32,564,0,55,718,41739
2004,Panama,PAN,-,-,0,0,0,0,0,0,0,0,0,0,0,0,0,0,108
2004,Paraguay,PRY,-,-,0,0,0,0,0,0,0,0,0,0,6,0,0,6,76
2004,Peru,PER,-,-,20,76,55,512,25,9,697,35,94,90,699,19,11,948,6870
2004,Philippines,PHL,-,-,0,0,0,0,0,0,0,0,0,0,5,0,0,5,62722
2004,Papua New Guinea,PNG,-,-,0,0,0,0,0,0,0,0,0,0,0,0,0,0,12
2004,Poland,POL,-,-,0,0,0,0,0,9,9,0,0,0,5,5,7,17,11252
2004,Portugal,PRT,-,-,0,0,0,0,0,0,0,0,0,0,0,0,7,7,255
2004,Qatar,QAT,-,-,0,0,0,0,0,0,0,0,0,0,0,0,0,0,10
2004,Romania,ROU,-,-,0,9,0,31,6,27,73,5,0,0,31,0,17,53,7382
2004,South Africa,ZAF,-,-,5,0,0,5,0,0,10,7,0,0,9,0,0,16,803
2004,Russian Federation,RUS,-,-,1517,3014,2595,6960,534,52,14672,1767,2309,1989,4365,797,43,11270,648476
2004,Rwanda,RWA,-,-,4834,2743,2354,6787,267,752,17737,5186,3054,2607,8989,289,698,20823,69146
2004,El Salvador,SLV,-,-,52,133,114,879,110,0,1288,46,154,133,984,143,0,1460,96264
2004,Saudi Arabia,SAU,-,-,0,10,0,5,0,0,15,0,0,6,0,0,0,6,295
2004,Serbia and Kosovo: S/RES/1244 (1999),SRB,-,-,3580,16264,13946,68318,19415,51970,173493,3962,17342,14867,67869,15570,56250,175860,579815
2004,Senegal,SEN,-,-,685,807,692,1506,113,0,3803,727,778,662,1306,169,0,3642,9869
2004,Seychelles,SYC,-,-,0,0,0,0,0,0,0,0,0,0,0,0,0,0,57
2004,Singapore,SGP,-,-,0,0,0,0,0,0,0,0,0,0,0,0,0,0,51
2004,Sierra Leone,SLE,-,-,668,1609,1369,4241,187,190,8264,836,2325,2008,6555,226,183,12133,49916
2004,Solomon Islands,SLB,-,-,0,0,0,0,0,0,0,0,0,0,0,0,0,0,71
2004,Somalia,SOM,-,-,14093,23044,19765,62999,3645,143,123689,15205,25399,21781,72235,3902,146,138668,411814
2004,Spain,ESP,-,-,0,0,0,0,0,0,0,0,0,0,0,0,0,0,81
2004,Viet Nam,VNM,-,-,95,100,97,729,10,145238,146269,119,138,128,1340,11,157671,159407,352697
2004,Sao Tome and Principe,STP,-,-,0,6,6,7,0,0,19,0,0,5,12,0,0,17,36
2004,Sudan,SDN,-,-,62335,57957,49707,124128,8866,51,303044,62982,64724,55500,117500,6564,63,307333,1404883
2004,Suriname,SUR,-,-,0,0,0,0,0,0,0,0,0,0,0,0,0,0,75
2004,Slovakia,SVK,-,-,0,0,0,0,0,8,8,0,0,0,0,0,0,0,830
2004,Slovenia,SVN,-,-,0,0,0,0,0,5,5,0,0,0,0,0,0,0,591
2004,Eswatini,SWZ,-,-,0,0,0,0,0,0,0,0,0,0,0,0,0,0,16
2004,Sweden,SWE,-,-,0,0,0,0,0,0,0,0,0,0,0,0,0,0,37
2004,Switzerland,CHE,-,-,0,0,0,0,0,0,0,0,0,0,0,0,0,0,11
2004,Syrian Arab Rep.,SYR,-,-,43,90,67,232,16,50,498,50,71,66,411,50,61,709,25211
2004,United Rep. of Tanzania,TZA,-,-,0,0,5,5,0,0,10,0,5,0,42,0,0,47,5321
2004,Thailand,THA,-,-,0,0,0,0,0,0,0,0,0,0,7,0,0,7,410
2004,Tajikistan,TJK,-,-,8441,3795,3253,11480,2374,0,29343,7616,3362,2881,10495,2568,0,26922,56933
2004,Turkmenistan,TKM,-,-,0,5,0,5,0,7,17,5,0,0,28,0,0,33,995
2004,Timor-Leste,TLS,-,-,0,0,0,0,0,0,0,0,0,0,0,0,0,0,221
2004,Togo,TGO,-,-,273,355,310,1488,22,74,2522,321,359,341,2344,28,93,3486,16274
2004,Tonga,TON,-,-,0,0,0,0,0,0,0,0,0,0,0,0,0,0,18
2004,Trinidad and Tobago,TTO,-,-,0,0,0,0,0,0,0,0,0,0,0,0,0,0,210
2004,Tunisia,TUN,-,-,5,0,9,27,0,241,282,11,0,10,58,0,406,485,2854
2004,Türkiye,TUR,-,-,634,1574,1365,3480,319,1995,9367,712,1671,1436,3410,273,2937,10439,179854
2004,Tuvalu,TUV,-,-,0,0,0,0,0,0,0,0,0,0,0,0,0,0,5
2004,United Arab Emirates,ARE,-,-,0,0,0,0,0,0,0,0,0,0,0,0,0,0,74
2004,Uganda,UGA,-,-,259,447,382,704,94,3176,5062,245,352,300,827,66,4761,6551,35157
2004,Ukraine,UKR,-,-,0,0,5,41,0,7,53,0,0,15,27,0,6,48,92224
2004,Uruguay,URY,-,-,0,0,0,0,0,0,0,0,0,0,0,0,0,0,205
2004,United States of America,USA,-,-,0,0,0,0,0,0,0,0,0,0,0,0,0,0,717
2004,Uzbekistan,UZB,-,-,0,11,0,23,0,0,34,5,0,18,15,0,8,46,9054
2004,Saint Vincent and the Grenadines,VCT,-,-,0,0,0,0,0,0,0,0,0,0,0,0,0,0,394
2004,Venezuela (Bolivarian Republic of),VEN,-,-,0,0,0,5,0,0,5,0,0,0,17,0,0,17,3933
2004,Western Sahara,ESH,-,-,14538,14856,12734,23715,10271,13780,89894,14502,16337,14004,24918,10274,12229,92264,191741
2004,Yemen,YEM,-,-,11,37,33,148,5,25,259,6,34,29,179,6,29,283,1937
2004,Zambia,ZMB,-,-,0,0,0,5,0,0,5,0,0,0,7,0,0,7,492
2004,Zimbabwe,ZWE,-,-,0,0,0,12,0,0,12,0,0,0,14,0,0,14,18955
2004,Stateless,XXA,-,-,5,29,26,71,0,16,147,10,29,25,150,0,41,255,17036
2004,Tibetan,TIB,-,-,0,0,0,0,0,9536,9536,0,0,0,0,0,10464,10464,20775
2004,Unknown ,UNK,-,-,26,65,54,297,39,70750,71231,13,64,79,566,69,92415,93206,584419
2005,Afghanistan,AFG,-,-,19402,45747,139896,197475,9650,532842,945012,19717,50752,153774,284353,18842,554593,1082031,2423023
2005,Albania,ALB,-,-,10,18,17,119,11,555,730,12,23,20,230,6,625,916,15290
2005,Algeria,DZA,-,-,8,27,38,81,0,428,582,6,36,29,256,0,785,1112,13405
2005,Andorra,AND,-,-,0,0,0,0,0,0,0,0,0,0,0,0,0,0,15
2005,Angola,AGO,-,-,7777,9298,7985,20774,2680,973,49487,8217,8871,7621,19132,2333,1545,47719,224147
2005,Antigua and Barbuda,ATG,-,-,0,0,0,7,0,0,7,0,0,0,0,0,0,0,20
2005,Egypt,EGY,-,-,0,7,7,47,0,45,106,5,8,7,99,5,82,206,8615
2005,Argentina,ARG,-,-,0,7,0,8,0,0,15,0,5,0,10,0,0,15,1135
2005,Armenia,ARM,-,-,5,36,36,152,10,658,897,5,38,37,196,5,628,909,18304
2005,Australia,AUS,-,-,0,0,0,0,0,0,0,0,0,0,0,0,0,0,41
2005,Austria,AUT,-,-,0,0,0,0,0,0,0,0,0,0,0,0,0,0,62
2005,Azerbaijan,AZE,-,-,5,24,13,183,55,429788,430068,0,16,16,258,50,368909,369249,816344
2005,Bahrain,BHR,-,-,0,0,0,0,0,0,0,0,0,0,0,0,0,0,62
2005,Barbados,BRB,-,-,0,0,0,7,0,0,7,0,0,5,6,0,0,11,26
2005,Burundi,BDI,-,-,21641,19290,16556,43000,1932,653,103072,23255,18712,16053,43568,2379,773,104740,458455
2005,Belgium,BEL,-,-,0,0,0,0,0,0,0,0,0,0,0,0,0,0,115
2005,Benin,BEN,-,-,0,0,0,5,0,9,14,0,0,0,34,0,8,42,674
2005,Bermuda,BMU,-,-,0,0,0,0,0,0,0,0,0,0,0,0,0,0,5
2005,Bangladesh,BGD,-,-,10,10,8,93,0,147,268,10,26,12,633,6,1067,1754,17459
2005,Bahamas,BHS,-,-,0,0,0,0,0,0,0,0,0,0,0,0,0,0,18
2005,Bhutan,BTN,-,-,4813,8569,7344,28605,2695,5,52031,5126,8789,7534,29419,3354,14,54236,117644
2005,Burkina Faso,BFA,-,-,0,0,0,0,0,6,6,0,0,0,36,0,26,62,801
2005,Belarus,BLR,-,-,0,5,0,9,5,141,160,0,5,0,31,0,163,199,10274
2005,Bolivia (Plurinational State of),BOL,-,-,0,0,0,0,0,11,11,0,0,0,11,0,14,25,615
2005,Botswana,BWA,-,-,0,0,0,8,0,0,8,0,0,0,0,0,0,0,8
2005,Brazil,BRA,-,-,0,8,0,35,0,6,49,0,0,6,40,0,0,46,960
2005,Brunei Darussalam,BRN,-,-,0,0,0,0,0,0,0,0,0,0,0,0,0,0,47
2005,Bosnia and Herzegovina,BIH,-,-,2861,8814,7560,61448,17015,3752,101450,2975,9125,7822,58324,11622,3818,93686,294494
2005,Bulgaria,BGR,-,-,0,0,0,31,6,36,73,0,5,0,45,0,51,101,5462
2005,Belize,BLZ,-,-,0,5,0,0,0,0,5,0,0,0,0,0,0,0,29
2005,Cambodia,KHM,-,-,26,41,43,238,10,8505,8863,15,62,49,259,16,8260,8661,18665
2005,Canada,CAN,-,-,0,0,0,0,0,0,0,0,0,0,0,0,0,0,155
2005,Central African Rep.,CAF,-,-,5108,4361,3726,8827,340,189,22551,4931,3707,3205,7129,491,251,19714,44714
2005,Chad,TCD,-,-,152,271,229,818,7,186,1663,191,245,174,1835,36,569,3050,54498
2005,China,CHN,-,-,17,74,33,838,64,428,1454,47,43,38,1347,38,571,2084,143464
2005,Chile,CHL,-,-,0,7,0,23,0,43,73,0,0,5,32,0,40,77,1010
2005,Cameroon,CMR,-,-,20,5,16,99,0,131,271,0,10,11,369,0,320,710,13952
2005,Congo,COG,-,-,878,1021,892,3410,92,1284,7577,803,993,871,5019,112,1246,9044,32596
2005,Dem. Rep. of the Congo,COD,-,-,34020,35647,30549,74541,4928,5811,185496,36813,36620,31394,67335,3729,7100,182991,486869
2005,Comoros,COM,-,-,0,0,0,0,0,6,6,0,0,0,5,0,21,26,573
2005,Colombia,COL,-,-,567,751,644,2510,138,1032509,1037119,656,796,685,3175,218,973899,979429,2540091
2005,Costa Rica,CRI,-,-,5,6,6,33,0,0,50,5,6,5,41,0,0,57,309
2005,Cuba,CUB,-,-,6,36,27,371,20,58,518,14,33,27,787,32,80,973,20674
2005,Cabo Verde,CPV,-,-,0,0,0,0,0,0,0,0,0,0,0,0,0,0,14
2005,Cyprus,CYP,-,-,0,0,0,0,0,0,0,0,0,0,0,0,0,0,5
2005,Czechia,CZE,-,-,0,0,0,5,0,19,24,0,0,0,9,5,22,36,3792
2005,Denmark,DNK,-,-,0,0,5,0,0,0,5,0,0,0,0,0,0,0,15
2005,Djibouti,DJI,-,-,7,0,0,14,0,29,50,9,0,0,28,0,29,66,713
2005,Dominica,DMA,-,-,0,0,0,7,0,0,7,0,0,0,5,0,0,5,76
2005,Dominican Rep.,DOM,-,-,0,5,0,10,0,0,15,0,0,0,12,0,0,12,139
2005,Ecuador,ECU,-,-,11,0,0,13,0,17,41,5,0,0,23,0,24,52,1046
2005,Equatorial Guinea,GNQ,-,-,0,0,8,17,0,12,37,0,13,0,29,0,17,59,528
2005,Eritrea,ERI,-,-,509,512,471,2045,149,47,3733,555,559,483,7158,24,239,9018,184188
2005,Estonia,EST,-,-,0,0,0,0,0,6,6,0,0,0,10,0,5,15,870
2005,Ethiopia,ETH,-,-,853,930,797,5492,78,257,8407,937,1150,999,11344,248,253,14931,81668
2005,Fiji,FJI,-,-,0,0,5,11,5,0,21,0,0,0,15,0,0,15,1746
2005,Finland,FIN,-,-,0,0,0,0,0,0,0,0,0,0,0,0,0,0,10
2005,New Caledonia,NCL,-,-,0,0,0,0,0,0,0,0,0,0,0,0,0,0,7
2005,France,FRA,-,-,0,5,0,6,0,0,11,8,0,0,5,0,0,13,340
2005,Gabon,GAB,-,-,0,0,0,0,0,0,0,0,0,0,10,0,6,16,133
2005,Gambia,GMB,-,-,5,0,0,31,0,17,53,0,0,0,96,0,38,134,2339
2005,Palestinian,PSE,-,-,929,2491,2141,8612,930,46,15149,939,2640,2268,9013,964,116,15940,356716
2005,United Kingdom of Great Britain and Northern Ireland,GBR,-,-,0,0,0,0,0,0,0,0,0,0,0,0,0,0,191
2005,Georgia,GEO,-,-,6492,11144,9561,82526,19448,787,129958,7155,11689,10015,65218,11423,749,106249,247352
2005,Germany,DEU,-,-,0,6,0,8,0,9,23,0,0,8,10,0,0,18,140
2005,Ghana,GHA,-,-,0,12,7,90,0,245,354,0,22,10,272,5,390,699,20748
2005,Guinea-Bissau,GNB,-,-,6,5,0,24,0,234,269,5,6,7,93,0,617,728,1285
2005,Greece,GRC,-,-,0,0,0,12,0,0,12,0,0,0,5,0,0,5,376
2005,Grenada,GRD,-,-,0,0,9,49,5,0,63,0,0,5,33,0,0,38,252
2005,Guatemala,GTM,-,-,5,28,26,451,38,5,553,10,14,11,246,565,10,856,35224
2005,Guinea,GIN,-,-,5,24,22,76,0,289,416,0,21,37,198,0,608,864,9084
2005,Guyana,GUY,-,-,5,13,11,87,0,0,116,5,10,8,113,0,0,136,790
2005,Haiti,HTI,-,-,11,18,17,133,19,962,1160,10,8,7,211,5,1275,1516,27053
2005,"China, Hong Kong SAR",HKG,-,-,0,0,0,9,0,0,9,0,0,0,0,0,0,0,19
2005,Honduras,HND,-,-,0,10,6,44,5,0,65,5,11,5,130,0,0,151,1761
2005,Croatia,HRV,-,-,166,494,429,4123,1088,54,6354,133,522,450,4135,794,47,6081,124166
2005,Hungary,HUN,-,-,0,10,8,52,0,35,105,5,13,12,49,16,48,143,3770
2005,Iceland,ISL,-,-,0,0,0,0,0,0,0,0,0,0,0,0,0,0,10
2005,Cote d'Ivoire,CIV,-,-,961,1243,1046,3571,208,20008,27037,969,1427,1198,5762,239,19135,28730,62720
2005,India,IND,-,-,10,15,18,182,11,37,273,8,24,32,891,11,189,1155,28444
2005,Indonesia,IDN,-,-,775,418,355,4104,76,0,5728,862,501,422,15024,87,0,16896,39099
2005,Ireland,IRL,-,-,0,0,0,0,0,0,0,0,0,0,0,0,0,0,23
2005,Iran (Islamic Rep. of),IRN,-,-,260,967,846,3404,208,1065,6750,246,1157,1038,4550,300,1688,8979,112309
2005,Iraq,IRQ,-,-,3528,6993,11322,27569,2149,1656,53217,3703,7611,12127,42576,2151,2079,70247,1513013
2005,Israel,ISR,-,-,17,16,14,75,7,0,129,20,26,15,116,5,0,182,1244
2005,Italy,ITA,-,-,0,5,0,5,0,0,10,0,0,0,6,0,0,6,239
2005,Jamaica,JAM,-,-,0,0,8,57,6,0,71,0,5,5,81,0,0,91,777
2005,Jordan,JOR,-,-,6,5,10,21,0,17,59,12,10,0,74,0,11,107,2441
2005,Japan,JPN,-,-,0,0,0,0,0,0,0,0,0,0,0,0,0,0,61
2005,Kazakhstan,KAZ,-,-,7,5,5,22,0,152,191,6,0,0,109,0,121,236,4926
2005,Kenya,KEN,-,-,10,0,0,45,0,6,61,0,13,0,77,0,6,96,16069
2005,Kyrgyzstan,KGZ,-,-,0,5,5,10,0,47,67,0,10,5,14,0,45,74,3489
2005,Kiribati,KIR,-,-,0,0,0,0,0,0,0,0,0,0,0,0,0,0,36
2005,Rep. of Korea,KOR,-,-,5,20,17,90,5,0,137,8,18,15,72,5,0,118,587
2005,Dem. People's Rep. of Korea,PRK,-,-,0,0,0,0,0,0,0,0,0,0,0,0,0,0,354
2005,Kuwait,KWT,-,-,0,0,0,10,0,0,10,0,0,0,10,0,0,10,439
2005,Lao People's Dem. Rep.,LAO,-,-,26,35,31,570,5,3805,4472,46,44,35,767,25,4051,4968,24792
2005,Liberia,LBR,-,-,13923,20320,17403,51235,3303,63,106247,14436,19667,16854,45068,2232,151,98408,474933
2005,Libya,LBY,-,-,10,5,0,7,0,176,198,0,5,10,22,0,237,274,2319
2005,Saint Lucia,LCA,-,-,0,13,12,99,0,0,124,6,9,8,48,0,0,71,296
2005,Lebanon,LBN,-,-,0,13,12,67,10,28,130,6,18,14,138,7,78,261,20340
2005,Lesotho,LSO,-,-,0,0,0,0,0,0,0,0,0,0,0,0,0,0,6
2005,Sri Lanka,LKA,-,-,11157,23723,20319,99005,11520,5967,171691,11541,24761,21229,93917,11813,10194,173455,437073
2005,Lithuania,LTU,-,-,0,0,0,7,0,0,7,0,0,0,7,0,12,19,1621
2005,Latvia,LVA,-,-,0,0,0,9,0,27,36,0,0,0,5,0,19,24,2546
2005,"China, Macao SAR",MAC,-,-,0,0,0,0,0,0,0,0,5,0,0,0,0,5,13
2005,Madagascar,MDG,-,-,0,0,0,0,0,81,81,0,0,0,5,0,86,91,216
2005,Mauritania,MRT,-,-,3158,3640,3117,3960,680,576,15131,1922,2995,2577,3657,520,3195,14866,33947
2005,North Macedonia,MKD,-,-,20,76,64,236,11,84,491,10,85,74,213,44,105,531,9305
2005,Monaco,MCO,-,-,0,0,0,0,0,0,0,0,0,0,0,0,0,0,5
2005,Rep. of Moldova,MDA,-,-,5,0,0,26,0,146,177,0,0,0,26,5,149,180,12634
2005,Maldives,MDV,-,-,0,0,0,0,0,0,0,0,0,0,0,0,5,5,10
2005,Mexico,MEX,-,-,145,157,134,996,11,0,1443,136,186,159,1250,0,0,1731,14923
2005,Mali,MLI,-,-,0,0,0,19,0,1862,1881,0,14,0,31,0,1767,1812,4351
2005,Malaysia,MYS,-,-,0,0,5,31,0,0,36,0,0,5,31,0,0,36,572
2005,Malawi,MWI,-,-,0,0,0,0,0,0,0,0,0,0,0,0,0,0,3944
2005,Mongolia,MNG,-,-,0,5,0,20,0,69,94,0,5,0,20,0,48,73,1300
2005,Morocco,MAR,-,-,5,0,10,27,0,30,72,0,7,0,33,0,68,108,3363
2005,Mozambique,MOZ,-,-,0,0,0,0,0,5,5,5,0,0,0,0,8,13,459
2005,Mauritius,MUS,-,-,0,0,0,5,0,0,5,0,0,0,0,0,5,5,39
2005,Myanmar,MMR,-,-,12844,16445,14097,44521,2976,170,91053,13423,17262,14812,54190,2941,391,103019,205989
2005,Namibia,NAM,-,-,45,54,42,170,5,0,316,74,48,42,700,11,0,875,1261
2005,Nepal,NPL,-,-,5,0,0,169,0,5,179,0,0,7,540,0,21,568,4478
2005,Netherlands (Kingdom of the),NLD,-,-,0,8,0,7,0,0,15,0,0,6,5,0,0,11,195
2005,Niger,NER,-,-,0,5,0,5,0,11,21,0,0,0,16,0,17,33,1223
2005,Nicaragua,NIC,-,-,0,9,12,272,43,0,336,0,17,18,264,36,0,335,5886
2005,Nigeria,NGA,-,-,678,1268,1095,2697,93,133,5964,760,1208,1036,3083,168,238,6493,36138
2005,Norway,NOR,-,-,0,0,0,0,0,0,0,0,0,0,0,0,0,0,12
2005,New Zealand,NZL,-,-,0,0,0,5,0,0,5,0,0,0,0,0,0,0,10
2005,Oman,OMN,-,-,0,0,0,0,0,0,0,0,0,0,0,0,0,0,10
2005,Pakistan,PAK,-,-,74,83,79,393,21,92,742,81,106,114,1235,26,243,1805,46344
2005,Panama,PAN,-,-,0,0,0,12,0,0,12,0,5,0,11,0,0,16,100
2005,Paraguay,PRY,-,-,0,0,0,5,0,0,5,0,0,0,6,0,0,6,73
2005,Peru,PER,-,-,22,68,59,564,30,122,865,27,93,81,684,39,166,1090,6500
2005,Philippines,PHL,-,-,0,8,0,59,0,0,67,0,0,6,50,0,0,56,62640
2005,Papua New Guinea,PNG,-,-,0,0,0,0,0,0,0,0,0,0,0,0,0,0,37
2005,Poland,POL,-,-,0,0,0,20,5,105,130,0,5,0,27,5,84,121,20245
2005,Portugal,PRT,-,-,0,7,7,22,0,0,36,0,5,5,32,0,6,48,196
2005,Qatar,QAT,-,-,0,0,0,0,0,0,0,0,0,0,0,0,0,0,11
2005,Romania,ROU,-,-,5,10,0,48,12,68,143,11,5,0,79,0,68,163,12630
2005,South Africa,ZAF,-,-,5,0,0,8,0,5,18,11,0,0,0,0,10,21,412
2005,Russian Federation,RUS,-,-,374,554,484,1852,91,93156,96511,486,578,512,1622,63,82806,86067,421162
2005,Rwanda,RWA,-,-,3403,2586,2235,7861,198,3712,19995,3222,2697,2312,9871,293,3522,21917,116109
2005,El Salvador,SLV,-,-,5,133,115,935,142,5,1335,5,160,137,1185,131,10,1628,49486
2005,Saudi Arabia,SAU,-,-,0,0,0,12,0,0,12,0,0,6,12,0,0,18,211
2005,Serbia and Kosovo: S/RES/1244 (1999),SRB,-,-,2463,15823,13585,68656,19975,55855,176357,2677,16970,14582,68340,15946,60206,178721,539509
2005,Senegal,SEN,-,-,686,802,698,1513,113,36,3848,727,778,662,1338,169,96,3770,10495
2005,Seychelles,SYC,-,-,0,0,0,0,0,0,0,0,0,0,0,0,0,0,47
2005,Singapore,SGP,-,-,0,0,0,5,0,0,5,0,0,0,6,0,0,6,57
2005,Sierra Leone,SLE,-,-,594,1289,1087,4449,105,96,7620,695,1343,1161,6131,162,242,9734,46398
2005,San Marino,SMR,-,-,0,0,0,0,0,0,0,0,0,0,0,0,0,0,5
2005,Solomon Islands,SLB,-,-,5,0,0,0,0,0,5,5,0,0,0,0,0,5,37
2005,Somalia,SOM,-,-,15382,22547,19293,66225,3652,466,127565,16452,24561,21038,86955,4033,648,153687,828034
2005,Spain,ESP,-,-,0,0,0,6,0,0,6,0,0,0,0,0,0,0,69
2005,Viet Nam,VNM,-,-,8380,16366,14044,85133,20256,6518,150697,11396,18598,15932,91749,19630,8245,165550,360764
2005,Saint Kitts and Nevis,KNA,-,-,0,0,0,0,0,0,0,0,0,0,0,0,0,0,31
2005,Sao Tome and Principe,STP,-,-,0,0,9,0,0,0,9,0,0,5,9,0,0,14,23
2005,Sudan,SDN,-,-,52944,57277,49114,124847,8997,22254,315433,54035,61701,52884,112713,5970,22948,310251,1549028
2005,Suriname,SUR,-,-,0,0,0,0,0,0,0,0,0,0,0,0,0,0,47
2005,Slovakia,SVK,-,-,0,0,0,5,0,54,59,0,0,0,7,0,47,54,988
2005,Slovenia,SVN,-,-,0,0,6,0,0,0,6,0,0,0,0,0,0,0,173
2005,Eswatini,SWZ,-,-,0,0,0,0,0,0,0,0,0,0,0,0,0,0,17
2005,Sweden,SWE,-,-,0,5,0,0,0,0,5,0,0,0,0,0,0,0,85
2005,Switzerland,CHE,-,-,0,0,0,0,0,0,0,0,0,0,0,0,0,0,14
2005,Syrian Arab Rep.,SYR,-,-,44,80,91,303,22,111,651,69,75,80,504,49,258,1035,23387
2005,United Rep. of Tanzania,TZA,-,-,0,0,5,6,0,0,11,0,5,0,44,0,0,49,6778
2005,Thailand,THA,-,-,5,15,13,64,0,0,97,13,6,5,97,5,0,126,645
2005,Tajikistan,TJK,-,-,8371,3500,2990,10698,2384,11,27954,7242,3157,2727,9658,2046,14,24844,54905
2005,Turkmenistan,TKM,-,-,0,5,0,12,0,0,17,0,0,0,0,0,5,5,988
2005,Timor-Leste,TLS,-,-,0,0,0,0,0,0,0,0,0,0,0,0,0,0,251
2005,Togo,TGO,-,-,2933,3168,2720,11796,784,189,21590,3035,3249,2799,14500,384,430,24397,61558
2005,Tonga,TON,-,-,0,0,0,0,0,0,0,0,0,0,0,0,0,0,6
2005,Trinidad and Tobago,TTO,-,-,5,8,7,71,0,0,91,6,9,7,50,0,0,72,270
2005,Tunisia,TUN,-,-,0,0,11,21,0,301,333,11,6,0,62,0,671,750,3477
2005,Türkiye,TUR,-,-,409,1147,984,2639,302,4810,10291,458,1198,1026,2619,250,9740,15291,181867
2005,United Arab Emirates,ARE,-,-,0,0,0,0,0,0,0,0,0,0,0,0,0,0,46
2005,Uganda,UGA,-,-,245,524,447,1218,213,28,2675,291,616,557,1385,247,41,3137,38505
2005,Ukraine,UKR,-,-,0,0,14,162,16,355,547,0,9,0,171,6,313,499,86887
2005,Uruguay,URY,-,-,0,0,0,9,0,0,9,0,0,0,8,0,0,8,170
2005,United States of America,USA,-,-,68,16,14,25,0,0,123,69,14,12,26,0,0,121,931
2005,Uzbekistan,UZB,-,-,10,41,34,117,0,104,306,29,21,24,413,0,77,564,9787
2005,Saint Vincent and the Grenadines,VCT,-,-,8,20,18,189,0,0,235,9,17,14,78,0,0,118,632
2005,Venezuela (Bolivarian Republic of),VEN,-,-,0,15,6,36,0,0,57,0,7,7,44,0,0,58,5397
2005,Western Sahara,ESH,-,-,8418,8602,7374,13733,5947,1820,45894,8397,9475,8121,14625,5949,1689,48256,116670
2005,Yemen,YEM,-,-,5,29,37,102,5,31,209,5,30,27,139,6,32,239,1733
2005,Zambia,ZMB,-,-,0,0,5,6,0,0,11,0,5,0,0,0,0,5,624
2005,Zimbabwe,ZWE,-,-,28,35,24,282,5,10,384,22,29,21,284,0,11,367,28576
2005,Stateless,XXA,-,-,0,10,23,49,0,16,98,6,8,18,106,0,41,179,14214
2005,Tibetan,TIB,-,-,6,66,56,130,6,9610,9874,5,101,87,464,7,10543,11207,21134
2005,Unknown ,UNK,-,-,256,285,214,717,28,6075,7575,297,302,268,1110,52,10626,12655,325983
2006,Afghanistan,AFG,-,-,32890,112727,9556,206838,12247,585763,960021,35094,122247,91542,287544,20541,593576,1150544,2352151
2006,Albania,ALB,-,-,0,5,0,13,0,798,816,0,0,0,6,0,995,1001,16358
2006,Algeria,DZA,-,-,0,9,23,64,9,571,676,0,10,17,187,0,997,1211,9869
2006,Andorra,AND,-,-,0,0,0,0,0,0,0,0,0,0,0,0,0,0,10
2006,Angola,AGO,-,-,10458,20975,2881,36355,5255,2662,78586,9686,21565,2380,29439,4741,3954,71765,208059
2006,Antigua and Barbuda,ATG,-,-,0,0,0,0,0,0,0,0,0,0,0,0,8,8,26
2006,Egypt,EGY,-,-,0,11,12,23,0,80,126,0,5,0,50,0,143,198,9283
2006,Argentina,ARG,-,-,0,0,0,0,0,15,15,0,0,0,0,0,20,20,1064
2006,Armenia,ARM,-,-,0,5,5,50,5,962,1027,0,0,12,65,0,956,1033,20314
2006,Australia,AUS,-,-,0,0,0,0,0,0,0,0,0,0,0,0,0,0,34
2006,Austria,AUT,-,-,0,0,0,0,0,6,6,0,0,0,0,0,0,0,46
2006,Azerbaijan,AZE,-,-,0,10,8,632,184,421617,422451,0,0,21,638,96,378201,378956,815749
2006,Bahrain,BHR,-,-,0,0,0,0,0,0,0,0,0,0,0,0,0,0,70
2006,Barbados,BRB,-,-,0,0,0,0,0,21,21,0,0,0,0,0,16,16,65
2006,Burundi,BDI,-,-,24352,26250,35040,81211,2723,7851,177427,27200,29954,46551,91879,3121,7619,206324,415902
2006,Belgium,BEL,-,-,0,0,0,0,0,6,6,0,0,0,0,0,0,0,98
2006,Benin,BEN,-,-,0,0,5,0,0,6,11,0,0,0,17,0,17,34,361
2006,Bangladesh,BGD,-,-,0,0,7,5,0,253,265,0,0,19,1124,0,1375,2518,11805
2006,Bahamas,BHS,-,-,0,0,0,0,0,5,5,0,0,0,0,0,0,0,34
2006,Bhutan,BTN,-,-,3698,7369,7330,31151,3215,5,52768,4158,7883,7393,31822,3784,20,55060,119522
2006,Burkina Faso,BFA,-,-,0,0,0,0,0,19,19,0,0,0,0,0,40,40,566
2006,Belarus,BLR,-,-,0,0,5,0,0,268,273,0,0,0,5,0,317,322,11066
2006,Bolivia (Plurinational State of),BOL,-,-,0,0,0,0,0,27,27,0,0,0,11,0,34,45,795
2006,Botswana,BWA,-,-,0,0,0,0,0,17,17,0,0,0,0,0,10,10,37
2006,Brazil,BRA,-,-,0,0,0,0,0,27,27,0,0,0,0,0,39,39,1132
2006,Bosnia and Herzegovina,BIH,-,-,1760,6229,6853,53652,20325,4756,93575,1819,6369,7048,51405,14740,4675,86056,337133
2006,Bulgaria,BGR,-,-,0,0,0,10,0,64,74,0,0,0,5,0,114,119,4252
2006,Belize,BLZ,-,-,0,0,0,0,0,0,0,0,0,0,0,0,0,0,27
2006,Cambodia,KHM,-,-,24,28,46,170,10,8415,8693,22,23,48,200,17,8135,8445,18631
2006,Canada,CAN,-,-,0,0,0,0,0,0,0,0,0,0,0,0,0,0,138
2006,Central African Rep.,CAF,-,-,16642,24378,12905,54427,1999,209,110560,16878,24501,13062,50614,1800,264,107119,220777
2006,Chad,TCD,-,-,281,586,811,3208,35,12732,17653,330,560,850,5782,117,13204,20843,152402
2006,China,CHN,-,-,9,17,16,143,17,1477,1679,6,10,5,253,15,2188,2477,157862
2006,Chile,CHL,-,-,0,0,5,14,0,94,113,0,0,8,7,0,129,144,881
2006,Cameroon,CMR,-,-,0,10,0,38,0,281,329,0,15,0,283,0,479,777,13755
2006,Congo,COG,-,-,712,1041,807,3382,76,1380,7398,689,1056,718,4601,92,1454,8610,28955
2006,Dem. Rep. of the Congo,COD,-,-,31170,33469,35132,75275,4282,7910,187238,30413,32685,35520,65718,3267,8946,176549,1506416
2006,Comoros,COM,-,-,0,0,0,0,0,9,9,0,0,0,5,0,29,34,78
2006,Colombia,COL,-,-,635,917,875,2992,146,116759,122324,706,942,906,3785,223,152757,159319,3561707
2006,Costa Rica,CRI,-,-,0,0,0,0,0,25,25,5,0,0,0,0,29,34,357
2006,Cuba,CUB,-,-,0,18,27,397,22,172,636,9,28,31,773,37,291,1169,34901
2006,Cabo Verde,CPV,-,-,0,0,0,0,0,0,0,0,0,0,0,0,0,0,44
2006,Cyprus,CYP,-,-,0,0,0,0,0,0,0,0,0,0,0,0,0,0,5
2006,Czechia,CZE,-,-,0,0,0,0,0,17,17,0,0,0,0,5,32,37,2317
2006,Denmark,DNK,-,-,0,0,0,0,0,5,5,0,0,0,0,0,0,0,15
2006,Djibouti,DJI,-,-,0,7,0,14,0,82,103,9,0,0,27,0,81,117,585
2006,Dominica,DMA,-,-,0,0,0,0,0,7,7,0,0,0,0,0,0,0,66
2006,Dominican Rep.,DOM,-,-,0,0,0,0,0,23,23,0,0,0,14,0,27,41,264
2006,Ecuador,ECU,-,-,8,8,0,0,0,38,54,0,0,5,9,0,54,68,1142
2006,Equatorial Guinea,GNQ,-,-,0,8,0,28,0,13,49,0,21,11,32,0,17,81,487
2006,Eritrea,ERI,-,-,4935,8847,7478,27026,3999,32316,84601,5262,8008,6834,33363,4057,32366,89890,198793
2006,Estonia,EST,-,-,0,0,0,0,0,10,10,0,0,0,5,0,10,15,745
2006,Ethiopia,ETH,-,-,1082,1316,968,6949,116,7789,18220,1194,1544,1332,14571,329,7759,26729,90677
2006,Fiji,FJI,-,-,0,0,0,0,0,21,21,0,0,0,0,0,16,16,1934
2006,Finland,FIN,-,-,0,0,0,0,0,0,0,0,0,0,0,0,0,0,10
2006,France,FRA,-,-,0,0,0,0,0,7,7,0,0,0,0,0,6,6,114
2006,Gabon,GAB,-,-,0,0,0,0,0,13,13,0,0,0,0,0,12,12,136
2006,Gambia,GMB,-,-,5,0,0,18,0,17,40,0,5,0,54,0,51,110,2255
2006,Palestinian,PSE,-,-,6662,9269,6271,18163,1509,103,41977,7397,6457,11403,20058,1334,229,46878,341513
2006,United Kingdom of Great Britain and Northern Ireland,GBR,-,-,0,0,0,0,0,5,5,0,0,0,0,0,6,6,213
2006,Georgia,GEO,-,-,4827,11312,13220,79518,25753,1034,135664,5227,11777,13665,64706,16129,968,112472,322759
2006,Germany,DEU,-,-,0,0,0,0,0,25,25,0,0,0,0,0,23,23,194
2006,Ghana,GHA,-,-,5,0,15,49,0,260,329,0,5,17,147,5,426,600,11081
2006,Guinea-Bissau,GNB,-,-,6,0,0,24,0,257,287,0,0,7,101,0,623,731,1285
2006,Greece,GRC,-,-,0,0,0,5,0,0,5,0,0,0,0,0,0,0,116
2006,Grenada,GRD,-,-,0,0,0,0,0,34,34,0,0,0,0,0,7,7,240
2006,Guatemala,GTM,-,-,0,0,34,412,38,79,563,0,5,6,192,565,128,896,27025
2006,Guinea,GIN,-,-,0,13,13,44,0,570,640,0,13,18,150,0,916,1097,9488
2006,Guyana,GUY,-,-,0,0,0,0,0,101,101,0,0,0,0,0,103,103,835
2006,Haiti,HTI,-,-,0,6,5,30,0,1441,1482,0,0,5,86,0,1950,2041,31374
2006,"China, Hong Kong SAR",HKG,-,-,0,0,0,0,0,13,13,0,0,0,0,0,0,0,26
2006,Honduras,HND,-,-,0,0,0,33,0,52,85,0,0,10,38,0,124,172,2391
2006,Croatia,HRV,-,-,318,1968,2792,23758,13694,173,42703,306,2090,2987,27907,8282,189,41761,97960
2006,Hungary,HUN,-,-,0,0,0,0,0,63,63,0,0,0,5,11,160,176,3317
2006,Iceland,ISL,-,-,0,0,0,0,0,0,0,0,0,0,0,0,0,0,32
2006,Cote d'Ivoire,CIV,-,-,691,1174,993,7296,197,367724,378075,686,1209,1189,9862,254,343125,356325,741909
2006,India,IND,-,-,0,0,10,24,0,269,303,0,0,0,401,0,855,1256,24542
2006,Indonesia,IDN,-,-,636,160,174,2655,7,1355,4987,589,100,312,11022,61,1415,13499,37989
2006,Ireland,IRL,-,-,0,0,0,0,0,0,0,0,0,0,0,0,0,0,5
2006,Iran (Islamic Rep. of),IRN,-,-,605,1440,1287,4671,320,1450,9773,639,1465,1490,6161,344,2410,12509,116186
2006,Iraq,IRQ,-,-,105472,175931,126599,525951,47467,2490,983910,110127,186182,136481,504703,45591,4685,987769,3348693
2006,Israel,ISR,-,-,0,0,0,5,0,252,257,0,0,0,0,0,292,292,1815
2006,Italy,ITA,-,-,0,0,0,0,0,5,5,0,0,0,0,0,7,7,119
2006,Jamaica,JAM,-,-,0,0,0,0,0,70,70,0,0,0,0,0,69,69,931
2006,Jordan,JOR,-,-,7,14,7,8,0,43,79,12,6,0,62,0,70,150,2350
2006,Japan,JPN,-,-,0,0,0,0,0,5,5,0,0,0,0,0,0,0,198
2006,Kazakhstan,KAZ,-,-,0,0,5,13,0,218,236,0,0,5,83,0,180,268,8030
2006,Kenya,KEN,-,-,15,0,6,5,0,71,97,5,0,12,25,0,76,118,6431
2006,Kyrgyzstan,KGZ,-,-,0,5,5,0,0,88,98,0,5,5,15,0,87,112,3076
2006,Kiribati,KIR,-,-,0,0,0,0,0,0,0,0,0,0,0,0,0,0,44
2006,Rep. of Korea,KOR,-,-,0,0,0,0,0,133,133,0,0,0,0,0,119,119,1641
2006,Dem. People's Rep. of Korea,PRK,-,-,0,0,0,0,0,13,13,0,0,0,5,0,19,24,489
2006,Kuwait,KWT,-,-,0,0,5,14,0,0,19,0,0,0,27,0,5,32,733
2006,Lao People's Dem. Rep.,LAO,-,-,36,65,40,612,5,3772,4530,63,60,60,833,31,4044,5091,26733
2006,Liberia,LBR,-,-,5937,13026,9818,32281,1741,102,62905,6341,10831,9351,31441,1290,434,59688,165543
2006,Libya,LBY,-,-,0,0,0,0,0,175,175,0,6,0,11,0,263,280,2214
2006,Saint Lucia,LCA,-,-,0,0,0,0,0,86,86,0,0,0,0,0,53,53,307
2006,Lebanon,LBN,-,-,0,0,11,29,0,240,280,0,0,7,56,0,413,476,215409
2006,Lesotho,LSO,-,-,0,0,0,0,0,0,0,0,0,0,0,0,0,0,10
2006,Sri Lanka,LKA,-,-,11,24,35,250,0,280478,280798,16,21,54,1070,0,277396,278557,590837
2006,Lithuania,LTU,-,-,0,0,0,0,0,16,16,0,0,0,0,0,28,28,1088
2006,Latvia,LVA,-,-,0,0,0,5,0,47,52,0,0,0,5,0,27,32,1524
2006,"China, Macao SAR",MAC,-,-,0,0,0,0,0,0,0,0,0,5,0,0,0,5,13
2006,Madagascar,MDG,-,-,0,0,0,0,0,97,97,0,0,0,0,0,107,107,280
2006,Mauritania,MRT,-,-,3155,3729,3015,3928,680,648,15155,1913,2743,2809,3609,520,3383,14977,35215
2006,North Macedonia,MKD,-,-,10,32,32,114,9,178,375,7,38,47,108,14,222,436,9541
2006,Monaco,MCO,-,-,0,0,0,0,0,0,0,0,0,0,0,0,0,0,5
2006,Rep. of Moldova,MDA,-,-,0,0,0,0,0,201,201,0,5,0,5,0,188,198,12952
2006,Maldives,MDV,-,-,0,0,0,0,0,0,0,0,0,0,0,0,5,5,15
2006,Mexico,MEX,-,-,0,0,0,0,0,2179,2179,0,0,0,0,0,2653,2653,15117
2006,Mali,MLI,-,-,0,0,0,5,0,1902,1907,0,5,9,20,0,1793,1827,4497
2006,Malaysia,MYS,-,-,0,0,0,0,0,28,28,0,0,0,0,0,30,30,710
2006,Malawi,MWI,-,-,0,0,0,0,0,0,0,0,0,0,0,0,0,0,155
2006,Mongolia,MNG,-,-,0,0,0,0,0,145,145,0,0,0,0,0,114,114,2719
2006,Morocco,MAR,-,-,0,8,6,7,0,69,90,0,7,5,11,0,109,132,5281
2006,Mozambique,MOZ,-,-,0,0,0,0,0,5,5,0,0,0,0,0,13,13,222
2006,Malta,MLT,-,-,0,0,0,0,0,0,0,0,0,0,0,0,0,0,30
2006,Montenegro,MNE,-,-,0,0,0,0,0,0,0,0,0,0,0,0,0,0,16455
2006,Mauritius,MUS,-,-,0,0,0,0,0,6,6,0,0,0,0,0,5,5,96
2006,Myanmar,MMR,-,-,13389,17316,14558,46833,3286,294,95676,14085,18102,15381,60958,3198,743,112467,287628
2006,Namibia,NAM,-,-,0,0,0,5,0,9,14,0,0,0,0,0,0,0,1210
2006,Nepal,NPL,-,-,5,5,0,176,0,47,233,0,10,5,573,0,125,713,105075
2006,Netherlands (Kingdom of the),NLD,-,-,0,0,0,0,0,5,5,0,0,0,0,0,5,5,79
2006,Niger,NER,-,-,0,0,0,6,0,22,28,0,0,0,5,0,38,43,1273
2006,Nicaragua,NIC,-,-,0,0,14,239,43,8,304,0,0,11,257,34,12,314,4127
2006,Nigeria,NGA,-,-,286,416,279,948,29,484,2442,341,423,261,1436,61,761,3283,21603
2006,New Zealand,NZL,-,-,0,0,0,0,0,0,0,0,0,0,0,0,0,0,12
2006,Oman,OMN,-,-,0,0,0,0,0,0,0,0,0,0,0,0,0,0,37
2006,Pakistan,PAK,-,-,40,57,46,152,5,464,764,40,36,37,1154,5,869,2141,32399
2006,Panama,PAN,-,-,0,0,0,0,0,0,0,0,0,0,0,0,8,8,90
2006,Paraguay,PRY,-,-,0,0,0,0,0,13,13,0,0,0,5,0,15,20,139
2006,Peru,PER,-,-,16,57,59,445,33,235,845,12,80,72,518,28,324,1034,8900
2006,Philippines,PHL,-,-,0,0,0,15,0,53,68,0,0,0,15,0,59,74,62993
2006,Papua New Guinea,PNG,-,-,0,0,0,0,0,0,0,0,0,0,0,0,0,0,33
2006,Poland,POL,-,-,0,0,0,0,0,312,312,0,0,0,5,5,358,368,13880
2006,Portugal,PRT,-,-,0,0,0,0,0,10,10,0,0,0,0,0,23,23,70
2006,Qatar,QAT,-,-,0,0,0,0,0,0,0,0,0,0,0,0,0,0,53
2006,Romania,ROU,-,-,0,0,0,10,7,196,213,0,0,0,10,0,231,241,8547
2006,South Africa,ZAF,-,-,0,0,0,0,0,18,18,0,0,0,0,0,32,32,650
2006,Russian Federation,RUS,-,-,401,386,961,2338,107,6047,10240,457,453,1031,2096,82,6206,10325,469529
2006,Rwanda,RWA,-,-,3137,3452,2494,9350,257,2558,21248,3029,3476,2650,11328,364,2273,23120,101570
2006,El Salvador,SLV,-,-,0,0,150,876,141,120,1287,0,0,177,1131,159,166,1633,35169
2006,Saudi Arabia,SAU,-,-,0,0,0,0,0,0,0,0,0,0,0,0,5,5,651
2006,Serbia and Kosovo: S/RES/1244 (1999),SRB,-,-,970,12074,11902,62711,19368,61406,168431,1044,12696,12856,63178,15687,63426,168887,506137
2006,Senegal,SEN,-,-,1230,2274,2564,1349,352,302,8071,1265,1347,1654,2633,453,119,7471,16379
2006,Seychelles,SYC,-,-,0,0,0,0,0,0,0,0,0,0,0,0,0,0,66
2006,Singapore,SGP,-,-,0,0,0,0,0,0,0,0,0,0,0,0,5,5,119
2006,Sierra Leone,SLE,-,-,1092,1698,2080,5575,311,150,10906,1183,1745,2063,7050,324,397,12762,48473
2006,Solomon Islands,SLB,-,-,0,0,0,0,0,15,15,0,0,0,0,0,11,11,63
2006,Somalia,SOM,-,-,16385,25644,20160,75480,4131,2131,143931,17298,27408,23058,102870,4741,2456,177831,888036
2006,Spain,ESP,-,-,0,0,0,0,0,0,0,0,0,0,0,0,5,5,2456
2006,Viet Nam,VNM,-,-,16,17,50,164,13,6208,6468,19,24,76,254,12,7977,8362,376516
2006,Saint Kitts and Nevis,KNA,-,-,0,0,0,0,0,0,0,0,0,0,0,0,5,5,5
2006,Sao Tome and Principe,STP,-,-,0,0,9,5,0,0,14,0,0,5,11,0,0,16,30
2006,Sudan,SDN,-,-,48697,70397,38967,124901,9130,662893,954985,49954,70637,46042,111594,6450,663497,948174,2028160
2006,Suriname,SUR,-,-,0,0,0,0,0,0,0,0,0,0,0,0,8,8,85
2006,Slovakia,SVK,-,-,0,0,0,0,0,59,59,0,0,0,0,0,48,48,1023
2006,Slovenia,SVN,-,-,0,0,0,0,0,6,6,0,0,0,0,0,0,0,1768
2006,Eswatini,SWZ,-,-,0,0,0,0,0,0,0,0,0,0,0,0,5,5,21
2006,Sweden,SWE,-,-,0,0,0,0,0,8,8,0,0,0,0,0,0,0,33
2006,Switzerland,CHE,-,-,0,0,0,0,0,0,0,0,0,0,0,0,0,0,38
2006,Syrian Arab Rep.,SYR,-,-,73,233,213,328,24,245,1116,86,253,249,463,51,611,1713,19820
2006,United Rep. of Tanzania,TZA,-,-,0,0,5,22,0,14,41,0,6,5,65,0,15,91,1870
2006,Thailand,THA,-,-,11,7,19,67,0,5,109,15,0,17,131,5,5,173,3524
2006,Tajikistan,TJK,-,-,11,21,153,363,35,12,595,17,24,142,389,24,15,611,1894
2006,Turkmenistan,TKM,-,-,0,0,5,9,0,0,14,0,0,0,5,0,8,13,835
2006,Timor-Leste,TLS,-,-,0,0,0,0,0,0,0,0,0,0,0,0,0,0,155490
2006,Togo,TGO,-,-,1483,1394,1484,5588,252,329,10530,1539,1476,1486,7801,147,650,13099,33906
2006,Tonga,TON,-,-,0,0,0,0,0,0,0,0,0,0,0,0,0,0,19
2006,Trinidad and Tobago,TTO,-,-,0,0,0,0,0,54,54,0,0,0,0,0,52,52,309
2006,Tunisia,TUN,-,-,5,0,11,0,0,348,364,19,0,6,36,0,725,786,3193
2006,Türkiye,TUR,-,-,1066,1761,1451,4021,370,5528,14197,1154,1771,1490,3825,339,11061,19640,239423
2006,Tuvalu,TUV,-,-,0,0,0,0,0,0,0,0,0,0,0,0,0,0,5
2006,United Arab Emirates,ARE,-,-,0,0,0,0,0,0,0,0,0,0,0,0,0,0,270
2006,Uganda,UGA,-,-,2008,2434,144,2742,1461,97,8886,1923,2391,267,2583,1558,128,8850,1609253
2006,Ukraine,UKR,-,-,0,0,0,21,0,595,616,0,0,0,18,0,514,532,67194
2006,Uruguay,URY,-,-,0,0,0,0,0,20,20,0,0,0,0,0,12,12,212
2006,United States of America,USA,-,-,0,0,0,0,0,166,166,0,0,0,0,0,207,207,1743
2006,Uzbekistan,UZB,-,-,21,40,43,71,0,163,338,31,48,11,148,0,146,384,11246
2006,Saint Vincent and the Grenadines,VCT,-,-,0,0,0,0,0,214,214,0,0,0,0,0,104,104,704
2006,Venezuela (Bolivarian Republic of),VEN,-,-,0,7,0,0,0,55,62,0,0,0,12,0,44,56,6188
2006,Western Sahara,ESH,-,-,0,0,0,0,0,13520,13520,0,0,94,501,0,12496,13091,116635
2006,Yemen,YEM,-,-,0,15,27,100,5,54,201,0,22,25,129,10,74,260,1715
2006,Zambia,ZMB,-,-,0,5,0,0,0,0,5,0,0,0,0,0,5,5,264
2006,Zimbabwe,ZWE,-,-,0,5,0,0,0,260,265,0,0,0,15,0,266,281,13981
2006,Stateless,XXA,-,-,5,6,38,53,0,12,114,0,15,21,97,0,48,181,13360
2006,Tibetan,TIB,-,-,5,20,29,56,0,9615,9725,0,30,51,191,5,10554,10831,20571
2006,Unknown ,UNK,-,-,188,214,295,991,16,26400,28104,150,244,323,1025,24,123425,125191,523785
2007,Afghanistan,AFG,-,-,39908,110878,66278,188894,11108,473104,890170,42023,118792,80175,222253,21870,591158,1076271,3227861
2007,Albania,ALB,-,-,8,17,29,120,7,697,878,9,15,25,219,11,794,1073,16980
2007,Algeria,DZA,-,-,5,26,19,121,0,517,688,5,28,31,278,0,920,1262,11939
2007,Andorra,AND,-,-,0,0,0,0,0,0,0,0,0,0,0,0,0,0,15
2007,Angola,AGO,-,-,2891,2623,3077,7345,808,1156,17900,2258,2286,2675,7212,692,1765,16888,186925
2007,Antigua and Barbuda,ATG,-,-,0,0,0,0,0,0,0,0,0,0,0,0,0,0,24
2007,Egypt,EGY,-,-,0,8,16,50,10,47,131,0,5,13,106,5,95,224,8403
2007,Argentina,ARG,-,-,0,5,0,16,0,5,26,0,5,0,22,0,0,27,1281
2007,Armenia,ARM,-,-,5,6,20,113,10,999,1153,0,14,22,141,0,978,1155,19420
2007,Australia,AUS,-,-,0,0,0,0,0,0,0,0,0,0,0,0,0,0,57
2007,Austria,AUT,-,-,0,0,0,5,0,0,5,0,0,0,0,0,0,0,24
2007,Azerbaijan,AZE,-,-,5,10,0,1488,658,854,3015,0,5,10,1519,284,839,2657,704411
2007,Bahrain,BHR,-,-,0,0,0,0,0,0,0,0,0,0,0,0,0,0,81
2007,Barbados,BRB,-,-,0,5,0,7,0,0,12,5,5,0,8,0,0,18,69
2007,Burundi,BDI,-,-,32118,31226,34045,74379,4942,308,177018,31983,31089,33142,69789,5383,309,171695,382760
2007,Belgium,BEL,-,-,0,5,0,0,0,0,5,0,0,0,0,0,0,0,63
2007,Benin,BEN,-,-,0,0,0,12,0,18,30,0,5,0,32,0,7,44,420
2007,Bangladesh,BGD,-,-,5,11,5,69,0,179,269,0,22,9,642,5,1329,2007,17563
2007,Bahamas,BHS,-,-,0,0,0,9,0,0,9,0,0,6,0,0,0,6,37
2007,Bhutan,BTN,-,-,4031,6736,6846,31498,3439,1227,53777,4244,7050,7026,32071,3982,1244,55617,112230
2007,Burkina Faso,BFA,-,-,5,0,0,11,0,19,35,0,5,0,27,0,32,64,811
2007,Belarus,BLR,-,-,0,10,5,25,8,240,288,0,0,21,51,5,310,387,6163
2007,Bolivia (Plurinational State of),BOL,-,-,0,15,0,19,0,18,52,0,0,0,26,0,27,53,844
2007,Botswana,BWA,-,-,0,9,0,27,0,0,36,0,0,0,12,0,0,12,69
2007,Brazil,BRA,-,-,0,7,0,33,5,9,54,0,0,8,43,0,5,56,1921
2007,Bosnia and Herzegovina,BIH,-,-,1685,6054,6709,52853,20261,3505,91067,1733,6200,6895,50638,14612,3654,83732,210360
2007,Bulgaria,BGR,-,-,0,0,7,39,5,54,105,0,5,0,55,0,77,137,3713
2007,Belize,BLZ,-,-,0,0,5,0,0,0,5,0,0,0,5,0,0,5,23
2007,Cambodia,KHM,-,-,13,22,29,126,15,8318,8523,5,19,23,149,11,8025,8232,18115
2007,Canada,CAN,-,-,0,0,9,0,0,0,9,0,5,0,0,0,0,5,589
2007,Central African Rep.,CAF,-,-,18170,26829,15911,60905,2086,1473,125374,21069,26864,15760,56980,2151,1534,124358,296425
2007,Chad,TCD,-,-,201,516,641,2744,45,22732,26879,219,470,696,5217,119,23189,29910,237283
2007,China,CHN,-,-,44,80,72,1237,90,524,2047,59,79,60,1806,63,847,2914,164613
2007,Chile,CHL,-,-,0,0,11,51,0,79,141,0,0,14,49,0,88,151,1091
2007,Cameroon,CMR,-,-,19,15,6,194,5,226,465,16,10,0,516,0,461,1003,14472
2007,Congo,COG,-,-,511,997,754,3123,90,1419,6894,568,928,686,4359,92,1471,8104,25798
2007,Dem. Rep. of the Congo,COD,-,-,27683,30471,30989,66742,3553,6112,165550,26988,30725,30189,62535,2997,6896,160330,1724542
2007,Comoros,COM,-,-,0,0,0,0,0,11,11,0,0,0,10,0,44,54,134
2007,Colombia,COL,-,-,56874,249089,216208,876833,70921,287,1470212,61840,269854,234419,954178,77264,368,1597923,3594838
2007,Costa Rica,CRI,-,-,0,6,0,11,0,0,17,10,0,0,21,0,0,31,422
2007,Cuba,CUB,-,-,12,45,84,785,51,82,1059,29,66,103,1446,82,91,1817,8561
2007,Cabo Verde,CPV,-,-,0,0,0,0,0,0,0,0,0,0,0,0,0,0,33
2007,Cyprus,CYP,-,-,0,0,0,5,0,0,5,0,0,0,0,0,0,0,10
2007,Czechia,CZE,-,-,5,5,10,25,0,11,56,0,7,5,25,5,16,58,1512
2007,Denmark,DNK,-,-,0,0,0,0,0,0,0,0,0,0,0,0,0,0,15
2007,Djibouti,DJI,-,-,5,7,0,23,5,59,99,11,9,0,27,0,69,116,672
2007,Dominica,DMA,-,-,0,0,0,8,0,0,8,0,0,0,0,0,0,0,66
2007,Dominican Rep.,DOM,-,-,0,5,10,42,0,0,57,0,0,5,60,0,0,65,483
2007,Ecuador,ECU,-,-,14,38,11,26,0,12,101,17,13,12,57,5,27,131,1607
2007,Equatorial Guinea,GNQ,-,-,0,10,5,30,0,13,58,0,20,5,42,0,17,84,431
2007,Eritrea,ERI,-,-,5899,9987,12311,36614,4431,20334,89576,5922,8311,11343,52097,4352,21191,103216,220924
2007,Estonia,EST,-,-,0,0,0,0,0,5,5,0,0,0,5,0,10,15,313
2007,Ethiopia,ETH,-,-,1263,1478,1456,8689,177,6044,19107,1291,1740,1624,15229,344,5780,26008,89314
2007,Fiji,FJI,-,-,0,0,0,21,5,0,26,0,0,8,18,5,0,31,2017
2007,Finland,FIN,-,-,0,0,0,0,0,0,0,0,0,0,0,0,0,0,5
2007,France,FRA,-,-,0,0,6,10,0,0,16,0,0,6,12,0,0,18,147
2007,Gabon,GAB,-,-,0,0,6,0,0,5,11,0,0,0,0,0,16,16,137
2007,Gambia,GMB,-,-,6,6,0,25,0,17,54,0,0,0,91,0,45,136,2253
2007,Palestinian,PSE,-,-,6851,9077,5926,15958,5046,52,42910,7595,6171,11074,21030,1405,122,47397,343647
2007,United Kingdom of Great Britain and Northern Ireland,GBR,-,-,0,0,0,5,0,0,5,0,5,0,0,0,0,5,234
2007,Georgia,GEO,-,-,4609,9961,9716,69858,23311,1003,118458,4938,10882,9861,54761,14609,886,95937,289059
2007,Germany,DEU,-,-,5,12,0,14,0,11,42,0,5,5,16,0,5,31,193
2007,Ghana,GHA,-,-,0,10,5,97,0,225,337,5,5,5,415,8,358,796,6678
2007,Guinea-Bissau,GNB,-,-,6,0,5,28,0,251,290,0,0,7,143,0,605,755,1265
2007,Greece,GRC,-,-,0,0,0,5,0,0,5,0,0,0,5,0,0,5,102
2007,Grenada,GRD,-,-,0,0,5,40,0,0,45,0,5,0,13,0,0,18,356
2007,Guatemala,GTM,-,-,7,21,10,199,17,5,259,12,10,17,270,23,20,352,21155
2007,Guinea,GIN,-,-,5,19,20,100,0,849,993,5,27,21,278,0,1110,1441,10193
2007,Guyana,GUY,-,-,5,5,12,85,0,0,107,0,7,11,72,0,0,90,919
2007,Haiti,HTI,-,-,168,194,127,1470,47,1270,3276,165,209,151,1876,29,1743,4173,32537
2007,"China, Hong Kong SAR",HKG,-,-,0,0,0,20,0,0,20,0,5,0,0,0,0,5,34
2007,Honduras,HND,-,-,5,14,9,82,5,21,136,8,9,15,173,0,38,243,1907
2007,Croatia,HRV,-,-,188,1815,2897,22898,13906,149,41853,186,1886,3041,27045,8588,146,40892,103419
2007,Hungary,HUN,-,-,0,6,0,22,0,29,57,0,7,5,28,11,118,169,3473
2007,Iceland,ISL,-,-,0,0,0,0,0,0,0,0,0,0,0,0,0,0,10
2007,Cote d'Ivoire,CIV,-,-,534,1110,939,4869,170,367753,375375,562,1146,1112,7959,218,343058,354055,738686
2007,India,IND,-,-,6,14,10,263,16,12,321,6,30,28,947,27,234,1272,27532
2007,Indonesia,IDN,-,-,180,451,625,707,5,6,1974,181,485,700,1393,5,0,2764,22902
2007,Ireland,IRL,-,-,0,0,0,0,0,0,0,0,0,0,0,0,0,0,9
2007,Iran (Islamic Rep. of),IRN,-,-,413,1285,1154,4662,275,1475,9264,433,1322,1366,6255,375,2350,12101,78772
2007,Iraq,IRQ,-,-,86820,146648,124379,540238,57123,1205437,2160645,91465,158495,138759,638143,56240,1242106,2325208,4722798
2007,Israel,ISR,-,-,43,44,27,227,30,5,376,46,46,35,266,10,0,403,2485
2007,Italy,ITA,-,-,0,5,0,0,0,0,5,0,0,5,0,0,0,5,94
2007,Jamaica,JAM,-,-,0,5,7,69,0,0,81,0,5,6,81,0,0,92,1002
2007,Jordan,JOR,-,-,13,5,5,59,5,0,87,14,8,13,133,5,21,194,2507
2007,Japan,JPN,-,-,0,0,0,5,0,0,5,0,0,0,0,0,0,0,538
2007,Kazakhstan,KAZ,-,-,0,5,10,30,7,192,244,0,0,18,94,5,149,266,5759
2007,Kenya,KEN,-,-,256,11,573,587,84,10,1521,275,23,450,550,78,11,1387,9261
2007,Kyrgyzstan,KGZ,-,-,0,6,5,15,0,75,101,0,10,5,25,0,79,119,2701
2007,Kiribati,KIR,-,-,0,0,0,0,0,0,0,0,0,0,0,0,0,0,36
2007,Rep. of Korea,KOR,-,-,8,21,21,122,5,0,177,11,24,21,89,5,0,150,1567
2007,Dem. People's Rep. of Korea,PRK,-,-,8,0,6,51,0,0,65,11,9,0,57,0,0,77,834
2007,Kuwait,KWT,-,-,0,0,0,11,0,5,16,0,7,0,23,0,6,36,845
2007,Lao People's Dem. Rep.,LAO,-,-,39,67,47,615,5,3712,4485,62,67,57,848,28,4044,5106,10176
2007,Liberia,LBR,-,-,4396,8508,6302,23002,1034,66,43308,4501,7954,6183,21834,864,168,41504,95060
2007,Libya,LBY,-,-,5,0,0,12,0,124,141,0,5,6,62,0,192,265,2552
2007,Saint Lucia,LCA,-,-,5,9,9,82,0,0,105,5,10,10,49,0,0,74,406
2007,Lebanon,LBN,-,-,6,23,17,183,31,31,291,12,37,24,268,22,101,464,85649
2007,Lesotho,LSO,-,-,0,0,0,0,0,0,0,0,0,0,0,0,0,0,17
2007,Sri Lanka,LKA,-,-,3579,6213,3354,18265,1822,243908,277141,3715,6628,3365,20375,1514,242704,278301,600486
2007,Lithuania,LTU,-,-,0,0,0,10,0,11,21,0,0,5,0,0,25,30,544
2007,Latvia,LVA,-,-,0,0,0,10,0,32,42,0,0,0,5,0,20,25,697
2007,"China, Macao SAR",MAC,-,-,0,0,0,0,0,0,0,0,0,5,0,0,0,5,13
2007,Madagascar,MDG,-,-,0,0,0,0,0,106,106,0,0,0,5,0,116,121,287
2007,Mauritania,MRT,-,-,3144,3700,3015,3899,680,693,15131,1910,2725,2814,3564,519,3386,14918,34096
2007,North Macedonia,MKD,-,-,10,48,48,168,14,109,397,14,55,50,173,14,136,442,9174
2007,Rep. of Moldova,MDA,-,-,5,0,0,27,5,179,216,0,0,0,31,0,192,223,5822
2007,Maldives,MDV,-,-,0,0,0,0,0,0,0,0,0,0,0,0,5,5,15
2007,Mexico,MEX,-,-,330,475,298,2599,19,0,3721,336,513,338,3327,20,0,4534,20329
2007,Mali,MLI,-,-,0,5,0,21,0,241,267,0,5,9,50,0,137,201,5114
2007,Malaysia,MYS,-,-,0,0,0,13,0,0,13,5,0,0,13,0,0,18,723
2007,Malawi,MWI,-,-,0,0,0,0,0,0,0,0,0,0,0,0,0,0,8277
2007,Mongolia,MNG,-,-,0,10,11,46,0,120,187,5,0,5,56,0,81,147,3061
2007,Morocco,MAR,-,-,0,0,16,61,0,35,112,7,0,0,55,0,89,151,4499
2007,Mozambique,MOZ,-,-,0,0,0,0,0,5,5,9,0,0,0,0,8,17,891
2007,Malta,MLT,-,-,0,0,0,0,0,0,0,0,0,0,0,0,0,0,10
2007,Montenegro,MNE,-,-,0,0,0,10,0,0,10,0,0,0,0,0,0,0,17005
2007,Mauritius,MUS,-,-,0,0,0,0,0,0,0,0,0,0,5,0,5,10,82
2007,Myanmar,MMR,-,-,12591,17112,13046,46176,3158,144,92227,13474,17704,14017,60939,3153,369,109656,277607
2007,Namibia,NAM,-,-,51,63,32,126,5,0,277,71,66,23,666,5,0,831,1139
2007,Nepal,NPL,-,-,0,13,0,206,5,19,243,5,5,0,767,5,48,830,55501
2007,Netherlands (Kingdom of the),NLD,-,-,0,0,0,7,0,0,7,0,0,0,5,0,0,5,66
2007,Niger,NER,-,-,0,0,5,10,0,19,34,8,0,0,18,0,28,54,1078
2007,Nicaragua,NIC,-,-,12,32,40,445,49,0,578,17,45,41,529,46,0,678,2721
2007,Nigeria,NGA,-,-,279,378,385,1387,53,228,2710,319,424,336,2436,71,326,3912,23623
2007,Norway,NOR,-,-,0,0,0,5,0,0,5,0,0,0,0,0,0,0,5
2007,New Zealand,NZL,-,-,0,0,0,0,0,0,0,0,0,0,0,0,0,0,17
2007,Oman,OMN,-,-,0,0,0,5,0,0,5,0,0,0,0,0,0,0,49
2007,Pakistan,PAK,-,-,92,91,70,370,40,127,790,58,92,79,1232,25,325,1811,40447
2007,Panama,PAN,-,-,0,0,0,18,0,0,18,0,0,5,19,0,0,24,134
2007,Paraguay,PRY,-,-,0,8,6,8,0,0,22,0,5,0,13,0,0,18,143
2007,Peru,PER,-,-,42,99,123,1147,46,117,1574,50,129,136,2461,52,165,2993,10794
2007,Philippines,PHL,-,-,0,5,5,149,5,0,164,0,6,0,97,5,0,108,63616
2007,Papua New Guinea,PNG,-,-,0,0,0,0,0,0,0,0,0,0,0,0,0,0,51
2007,Poland,POL,-,-,5,0,0,15,0,271,291,0,0,8,29,5,303,345,3098
2007,Portugal,PRT,-,-,0,5,0,11,0,0,16,0,0,5,14,0,7,26,70
2007,Qatar,QAT,-,-,0,0,0,0,0,0,0,0,0,0,0,0,0,0,57
2007,Romania,ROU,-,-,9,0,0,69,7,131,216,6,10,5,89,0,149,259,5860
2007,South Africa,ZAF,-,-,0,5,10,17,0,5,37,0,5,0,14,0,14,33,582
2007,Russian Federation,RUS,-,-,375,414,931,2467,134,6055,10376,454,435,988,2182,78,6226,10363,300379
2007,Rwanda,RWA,-,-,3190,3378,2608,8696,233,1943,20048,2992,3485,2651,10818,322,1667,21935,89188
2007,El Salvador,SLV,-,-,5,14,60,711,119,5,914,5,17,70,965,177,11,1245,24635
2007,Saudi Arabia,SAU,-,-,0,0,0,0,0,0,0,0,0,0,8,0,0,8,767
2007,Serbia and Kosovo: S/RES/1244 (1999),SRB,-,-,607,10863,12507,64290,20353,12589,121209,716,11585,13326,64910,16427,19279,126243,406673
2007,Senegal,SEN,-,-,1230,2279,2564,1601,352,50,8076,1265,1348,1665,2689,453,109,7529,16774
2007,Seychelles,SYC,-,-,0,0,8,0,0,0,8,0,0,0,0,0,0,0,62
2007,Singapore,SGP,-,-,0,0,0,0,0,0,0,0,0,0,7,0,0,7,131
2007,Sierra Leone,SLE,-,-,1013,1759,2018,5564,367,118,10839,1067,1840,2097,7033,356,249,12642,36768
2007,Solomon Islands,SLB,-,-,0,6,0,5,0,0,11,0,6,0,5,0,0,11,69
2007,Somalia,SOM,-,-,134770,138813,92177,284051,22742,557,673110,128601,143528,98041,302396,21081,722,694369,1473769
2007,Spain,ESP,-,-,0,0,0,0,0,0,0,0,0,0,11,0,7,18,48
2007,Viet Nam,VNM,-,-,10,19,51,173,0,5220,5473,7,38,51,299,5,6502,6902,329710
2007,Saint Kitts and Nevis,KNA,-,-,0,0,0,0,0,0,0,0,0,0,8,0,0,8,8
2007,Sao Tome and Principe,STP,-,-,0,8,0,6,0,0,14,0,0,5,13,0,0,18,32
2007,Sudan,SDN,-,-,18679,24926,22292,58622,3452,625231,753202,19576,26975,26468,70734,2102,625962,771817,1792435
2007,Suriname,SUR,-,-,0,0,0,0,0,0,0,0,0,0,9,0,0,9,71
2007,Slovakia,SVK,-,-,0,0,0,8,0,53,61,0,5,0,0,0,53,58,443
2007,Slovenia,SVN,-,-,0,0,0,0,0,0,0,0,0,0,9,0,0,9,56
2007,Eswatini,SWZ,-,-,0,0,0,6,0,0,6,0,0,0,0,0,0,0,85
2007,Sweden,SWE,-,-,0,0,0,5,0,0,5,0,0,0,0,0,0,0,22
2007,Switzerland,CHE,-,-,0,0,0,0,0,0,0,0,0,0,0,0,0,0,33
2007,Syrian Arab Rep.,SYR,-,-,64,121,83,398,19,573,1258,72,139,107,655,31,928,1932,20533
2007,United Rep. of Tanzania,TZA,-,-,0,5,10,26,0,0,41,0,0,0,67,6,5,78,4156
2007,Thailand,THA,-,-,10,17,13,126,0,0,166,13,19,7,231,5,0,275,2685
2007,Tajikistan,TJK,-,-,0,6,5,6,0,19,36,0,7,0,5,0,19,31,980
2007,Turkmenistan,TKM,-,-,0,0,0,14,0,6,20,0,0,0,8,0,5,13,801
2007,Timor-Leste,TLS,-,-,0,0,0,0,0,0,0,0,0,0,0,0,0,0,62631
2007,Togo,TGO,-,-,1083,1155,775,3602,195,377,7187,1053,1203,789,4325,103,687,8160,23782
2007,Tonga,TON,-,-,0,0,0,0,0,0,0,0,0,0,0,0,0,0,14
2007,Trinidad and Tobago,TTO,-,-,5,6,5,58,0,0,74,5,9,6,52,0,0,72,385
2007,Tunisia,TUN,-,-,6,0,11,44,0,319,380,0,10,5,92,0,664,771,2822
2007,Türkiye,TUR,-,-,818,1642,1464,4282,373,5090,13669,911,1799,1446,4359,277,10510,19302,231109
2007,United Arab Emirates,ARE,-,-,0,0,0,5,0,0,5,0,0,0,5,0,0,5,315
2007,Uganda,UGA,-,-,42,301,130,815,117,24,1429,125,471,243,1063,183,53,2138,1260447
2007,Ukraine,UKR,-,-,5,0,5,175,24,426,635,0,14,0,185,0,367,566,28398
2007,Uruguay,URY,-,-,0,0,0,8,0,5,13,0,0,0,10,0,0,10,224
2007,United States of America,USA,-,-,291,196,19,34,0,0,540,291,177,21,61,0,0,550,3264
2007,Uzbekistan,UZB,-,-,32,41,35,125,5,184,422,34,49,35,159,0,158,435,7493
2007,Holy See,VAT,-,-,0,0,0,0,0,0,0,0,5,0,0,0,0,5,5
2007,Saint Vincent and the Grenadines,VCT,-,-,15,26,34,273,0,0,348,14,21,19,102,0,0,156,1148
2007,Venezuela (Bolivarian Republic of),VEN,-,-,0,25,23,104,0,0,152,12,18,21,145,5,7,208,6840
2007,Western Sahara,ESH,-,-,0,0,0,0,0,8,8,0,0,47,532,0,7,586,116617
2007,Yemen,YEM,-,-,8637,9987,4806,19668,440,40,43578,8002,8111,4398,13014,352,55,33932,78927
2007,Zambia,ZMB,-,-,0,5,0,12,0,0,17,0,0,0,11,0,0,11,684
2007,Zimbabwe,ZWE,-,-,11,21,13,189,7,16,257,20,20,22,204,5,11,282,48684
2007,Stateless,XXA,-,-,19,30,33,127,0,14,223,17,31,28,206,6,45,333,15867
2007,Tibetan,TIB,-,-,0,0,0,0,0,9615,9615,0,0,0,0,0,10555,10555,20311
2007,Unknown ,UNK,-,-,185,308,263,830,119,2620,4325,195,287,293,1843,293,3885,6796,381251
2008,Afghanistan,AFG,-,-,34093,174915,149901,412308,24303,114018,909538,35776,189909,167603,496829,42239,119062,1051418,3089064
2008,Albania,ALB,-,-,15,25,38,179,19,744,1020,20,26,41,357,15,848,1307,16821
2008,Algeria,DZA,-,-,10,14,30,86,9,537,686,16,31,44,289,0,904,1284,10566
2008,Andorra,AND,-,-,0,0,0,0,0,0,0,0,0,0,0,0,0,0,10
2008,Angola,AGO,-,-,2681,3065,2627,6753,520,1172,16818,2610,3053,2588,7408,655,1803,18117,172108
2008,Antigua and Barbuda,ATG,-,-,0,5,0,12,0,0,17,0,0,0,8,0,0,8,50
2008,Egypt,EGY,-,-,0,29,6,54,12,48,149,9,17,10,148,14,106,304,8580
2008,Argentina,ARG,-,-,0,0,9,25,0,5,39,8,0,0,39,0,0,47,1178
2008,Armenia,ARM,-,-,6,13,54,179,10,1114,1376,5,21,47,192,5,1119,1389,20097
2008,Australia,AUS,-,-,0,0,0,9,0,0,9,0,0,0,0,0,0,0,46
2008,Austria,AUT,-,-,0,0,0,0,0,0,0,0,0,0,0,0,5,5,15
2008,Azerbaijan,AZE,-,-,0,5,34,1274,515,951,2779,0,5,45,1320,260,851,2481,621448
2008,Bahrain,BHR,-,-,0,0,0,0,0,0,0,0,0,0,0,0,0,0,82
2008,Barbados,BRB,-,-,0,5,0,19,0,0,24,0,6,0,15,0,0,21,78
2008,Burundi,BDI,-,-,23582,30783,16019,55773,3978,301,130436,23465,20989,25519,52687,4070,299,127029,388212
2008,Belgium,BEL,-,-,0,5,0,0,0,0,5,0,7,0,5,0,0,12,85
2008,Benin,BEN,-,-,0,5,0,10,0,12,27,5,0,7,35,0,13,60,494
2008,Bangladesh,BGD,-,-,17,19,5,83,0,199,323,18,15,10,481,5,1536,2065,16810
2008,Bahamas,BHS,-,-,0,7,0,5,0,0,12,0,0,9,0,0,0,9,37
2008,Bhutan,BTN,-,-,3843,6066,6208,29986,3245,1227,50575,4086,6379,6316,30702,3794,1244,52521,106054
2008,Burkina Faso,BFA,-,-,0,0,5,12,0,18,35,0,5,0,57,0,46,108,1029
2008,Belarus,BLR,-,-,7,10,10,33,10,237,307,5,5,14,75,5,305,409,6458
2008,Bolivia (Plurinational State of),BOL,-,-,0,10,8,24,0,18,60,5,0,11,34,0,27,77,608
2008,Botswana,BWA,-,-,0,7,7,96,0,0,110,0,5,0,33,0,0,38,177
2008,Brazil,BRA,-,-,0,6,7,54,5,9,81,0,9,0,73,0,5,87,1757
2008,Bosnia and Herzegovina,BIH,-,-,1585,5742,6337,50679,19597,29101,113041,1638,5832,6512,48635,14085,28248,104950,250545
2008,Bulgaria,BGR,-,-,0,5,6,48,6,53,118,0,0,6,49,6,76,137,3331
2008,Belize,BLZ,-,-,0,0,0,0,0,0,0,0,0,0,0,0,0,0,35
2008,Cambodia,KHM,-,-,6,11,21,63,5,8146,8252,5,5,15,75,5,7930,8035,17462
2008,Canada,CAN,-,-,0,0,0,0,0,0,0,0,0,0,0,0,0,0,155
2008,Central African Rep.,CAF,-,-,24479,38070,20119,69673,3087,332,155760,34377,44127,17561,57595,3507,412,157579,323303
2008,Chad,TCD,-,-,18218,27775,14807,38416,3461,17155,119832,18032,26972,13256,25005,2965,17625,103855,225141
2008,China,CHN,-,-,64,116,82,1536,143,595,2536,68,108,78,2244,82,917,3497,194784
2008,Chile,CHL,-,-,0,0,7,34,0,75,116,5,0,7,46,0,82,140,1116
2008,Cameroon,CMR,-,-,278,164,211,756,54,285,1748,219,124,185,904,22,521,1975,16763
2008,Congo,COG,-,-,330,977,805,2971,110,1464,6657,375,979,669,4023,118,1475,7639,24971
2008,Dem. Rep. of the Congo,COD,-,-,26065,32360,26232,66046,3564,5570,159837,25669,31239,26963,61602,2890,6402,154765,1864370
2008,Comoros,COM,-,-,0,0,0,5,0,82,87,0,0,0,0,0,257,257,412
2008,Colombia,COL,-,-,57391,249779,216813,880827,71098,838,1476746,62291,270580,235130,958589,77504,951,1605045,3426152
2008,Costa Rica,CRI,-,-,6,0,0,15,0,0,21,5,0,0,30,0,0,35,419
2008,Cuba,CUB,-,-,12,34,89,741,54,60,990,29,59,102,1259,90,94,1633,8795
2008,Cabo Verde,CPV,-,-,0,0,0,0,0,0,0,0,0,0,0,0,0,0,27
2008,Cyprus,CYP,-,-,0,0,0,0,0,0,0,0,0,0,5,0,0,5,10
2008,Czechia,CZE,-,-,56,52,46,210,8,23,395,41,64,35,233,13,31,417,2137
2008,Denmark,DNK,-,-,0,0,6,0,0,0,6,0,0,0,0,0,0,0,16
2008,Djibouti,DJI,-,-,7,17,0,32,0,63,119,5,13,6,32,0,66,122,693
2008,Dominica,DMA,-,-,0,0,5,7,0,0,12,0,0,0,7,0,0,7,75
2008,Dominican Rep.,DOM,-,-,0,8,5,43,0,0,56,0,0,6,74,0,0,80,580
2008,Ecuador,ECU,-,-,5,15,5,35,0,15,75,5,7,5,58,0,26,101,1307
2008,Equatorial Guinea,GNQ,-,-,0,10,10,24,0,13,57,0,5,18,53,0,17,93,429
2008,Eritrea,ERI,-,-,5806,9331,5958,36190,1829,15835,74949,6095,9828,6751,46880,2725,16817,89096,201645
2008,Estonia,EST,-,-,0,0,0,0,0,5,5,0,0,0,0,0,10,10,281
2008,Ethiopia,ETH,-,-,2198,2676,1522,12433,269,2842,21940,2311,3006,1829,18729,379,2110,28364,95369
2008,Fiji,FJI,-,-,0,0,0,26,8,0,34,0,0,8,21,5,0,34,2062
2008,France,FRA,-,-,0,0,8,15,0,0,23,5,0,6,11,0,0,22,152
2008,Gabon,GAB,-,-,0,5,14,0,0,5,24,0,0,0,0,0,15,15,155
2008,Gambia,GMB,-,-,6,6,5,23,0,26,66,0,5,37,152,0,48,242,2464
2008,Palestinian,PSE,-,-,6981,9147,6134,18106,1521,62,41951,7720,6153,11243,20345,1381,126,46968,342652
2008,United Kingdom of Great Britain and Northern Ireland,GBR,-,-,0,0,0,0,0,0,0,0,0,0,0,0,0,0,206
2008,Georgia,GEO,-,-,4299,9341,9138,66346,22377,1004,112505,4590,10139,9245,52107,13936,907,90924,347556
2008,Germany,DEU,-,-,5,8,5,20,0,11,49,0,9,5,24,0,5,43,262
2008,Ghana,GHA,-,-,998,1561,565,1652,21,218,5015,1105,1000,450,1477,21,356,4409,15221
2008,Guinea-Bissau,GNB,-,-,6,5,5,28,0,250,294,0,0,25,140,0,598,763,1309
2008,Greece,GRC,-,-,0,0,0,5,0,0,5,0,0,0,10,0,0,10,82
2008,Grenada,GRD,-,-,0,0,0,48,0,0,48,0,0,0,17,0,0,17,375
2008,Guatemala,GTM,-,-,10,29,30,184,25,5,283,13,25,66,337,21,20,482,16170
2008,Guinea,GIN,-,-,5,24,34,112,0,1187,1362,12,26,65,399,0,1433,1935,11493
2008,Guyana,GUY,-,-,0,7,19,86,5,0,117,0,5,10,103,5,0,123,983
2008,Haiti,HTI,-,-,414,441,269,2739,92,1335,5290,396,463,272,3478,60,1825,6494,35727
2008,"China, Hong Kong SAR",HKG,-,-,0,0,0,43,0,0,43,0,6,0,0,0,0,6,58
2008,Honduras,HND,-,-,20,25,25,152,6,0,228,25,17,29,366,0,0,437,2057
2008,Croatia,HRV,-,-,57,1305,2509,22856,14483,14939,56149,71,1328,2615,27113,9167,13254,53548,127726
2008,Hungary,HUN,-,-,10,16,9,80,0,45,160,10,15,24,119,6,146,320,1899
2008,Iceland,ISL,-,-,0,0,0,0,0,0,0,0,0,0,0,0,0,0,10
2008,Cote d'Ivoire,CIV,-,-,514,1047,836,4770,167,354969,362303,498,1041,1027,8054,198,330643,341461,712633
2008,India,IND,-,-,10,10,12,292,15,45,384,17,27,28,884,28,188,1172,26418
2008,Indonesia,IDN,-,-,152,218,179,826,46,6,1427,151,248,206,713,51,0,1369,21560
2008,Ireland,IRL,-,-,0,0,0,0,0,0,0,0,0,0,0,0,0,0,7
2008,Iran (Islamic Rep. of),IRN,-,-,475,1341,1195,5016,322,986,9335,473,1345,1448,6869,379,1729,12243,80199
2008,Iraq,IRQ,-,-,75658,123217,106512,466624,62391,1298699,2133101,78616,133077,115972,472712,53739,1352250,2206366,4584189
2008,Israel,ISR,-,-,40,53,25,270,32,0,420,49,49,37,330,15,0,480,2523
2008,Italy,ITA,-,-,0,0,8,9,0,0,17,0,0,0,8,0,0,8,87
2008,Jamaica,JAM,-,-,0,13,14,136,5,0,168,6,7,11,140,5,0,169,1226
2008,Jordan,JOR,-,-,7,18,0,135,8,5,173,14,5,13,177,5,16,230,2625
2008,Japan,JPN,-,-,0,0,0,8,0,0,8,5,0,0,0,0,0,5,209
2008,Kazakhstan,KAZ,-,-,0,0,0,25,8,200,233,0,5,0,26,5,145,181,5404
2008,Kenya,KEN,-,-,422,260,728,1053,97,13,2573,430,253,608,1049,99,20,2459,415879
2008,Kyrgyzstan,KGZ,-,-,0,7,0,17,5,87,116,0,5,0,31,0,79,115,2933
2008,Kiribati,KIR,-,-,0,0,0,0,0,0,0,0,0,0,0,0,0,0,36
2008,Rep. of Korea,KOR,-,-,10,31,31,154,7,0,233,9,33,21,99,0,0,162,1608
2008,Dem. People's Rep. of Korea,PRK,-,-,9,0,0,49,0,0,58,10,7,7,61,0,9,94,1094
2008,Kuwait,KWT,-,-,0,0,0,6,0,0,6,0,5,6,27,0,0,38,908
2008,Lao People's Dem. Rep.,LAO,-,-,27,59,43,104,5,3699,3937,39,61,41,145,7,3992,4285,8774
2008,Liberia,LBR,-,-,3545,6435,4361,19486,840,71,34738,3594,6313,4134,18664,710,169,33584,77602
2008,Libya,LBY,-,-,6,5,0,16,0,112,139,11,5,0,62,0,191,269,2821
2008,Saint Lucia,LCA,-,-,9,14,16,167,0,0,206,12,13,7,98,0,0,130,624
2008,Lebanon,LBN,-,-,14,29,12,183,35,38,311,8,26,31,293,27,107,492,15242
2008,Lesotho,LSO,-,-,0,0,0,0,0,0,0,0,0,0,0,0,0,0,22
2008,Sri Lanka,LKA,-,-,189,232,166,1420,254,296062,298323,172,252,192,4784,106,300995,306501,649579
2008,Lithuania,LTU,-,-,0,0,5,7,0,9,21,0,0,7,5,0,24,36,546
2008,Latvia,LVA,-,-,0,0,0,12,0,31,43,0,0,0,12,0,19,31,789
2008,"China, Macao SAR",MAC,-,-,0,0,0,0,0,0,0,0,0,0,0,0,0,0,8
2008,Madagascar,MDG,-,-,0,0,0,5,0,104,109,0,0,5,10,0,117,132,298
2008,Mauritania,MRT,-,-,3768,4555,3956,6901,1406,763,21349,2536,4113,3493,6818,1258,3438,21656,46365
2008,North Macedonia,MKD,-,-,5,22,17,80,5,105,234,12,18,19,85,0,138,272,8587
2008,Rep. of Moldova,MDA,-,-,5,0,5,50,5,187,252,0,0,0,68,0,189,257,6430
2008,Maldives,MDV,-,-,0,0,0,0,0,0,0,0,0,0,0,0,5,5,15
2008,Mexico,MEX,-,-,437,589,407,3305,18,0,4756,417,610,412,4448,27,5,5919,23595
2008,Mali,MLI,-,-,5,5,0,16,0,645,671,0,0,5,70,0,409,484,2489
2008,Malaysia,MYS,-,-,0,0,5,12,0,0,17,0,0,5,19,0,5,29,735
2008,Malawi,MWI,-,-,0,0,0,7,0,0,7,0,0,0,0,0,0,0,8309
2008,Mongolia,MNG,-,-,9,11,17,110,0,129,276,14,0,21,93,0,89,217,3398
2008,Morocco,MAR,-,-,5,0,7,67,0,35,114,0,0,5,60,0,91,156,4046
2008,Mozambique,MOZ,-,-,0,0,0,0,0,5,5,0,14,0,0,0,8,22,876
2008,Malta,MLT,-,-,0,0,0,0,0,0,0,0,0,0,0,0,0,0,10
2008,Montenegro,MNE,-,-,0,5,0,10,0,19,34,0,6,7,6,0,7,26,1460
2008,Mauritius,MUS,-,-,0,0,0,5,0,0,5,0,0,0,0,0,0,0,41
2008,Myanmar,MMR,-,-,13042,16220,12919,45209,3036,311,90737,13691,16733,14340,58287,3112,597,106760,274028
2008,Namibia,NAM,-,-,42,55,26,152,0,0,275,56,57,22,538,12,0,685,999
2008,Nepal,NPL,-,-,0,7,8,119,5,23,162,0,6,0,568,0,48,622,6283
2008,Netherlands (Kingdom of the),NLD,-,-,0,0,0,9,0,0,9,0,0,5,0,0,0,5,71
2008,Niger,NER,-,-,0,5,0,13,0,25,43,8,0,5,87,0,34,134,1053
2008,Nicaragua,NIC,-,-,12,34,40,344,31,0,461,24,36,36,468,30,0,594,1999
2008,Nigeria,NGA,-,-,283,416,395,1576,55,270,2995,330,450,372,3143,66,356,4717,24619
2008,New Zealand,NZL,-,-,0,0,0,0,0,0,0,0,0,0,0,0,0,0,13
2008,Oman,OMN,-,-,0,0,0,0,0,0,0,0,0,0,0,0,0,0,55
2008,Pakistan,PAK,-,-,12441,19919,10233,30329,1561,137,74620,13681,24110,12419,31132,2171,336,83849,194442
2008,Panama,PAN,-,-,0,0,5,18,0,0,23,0,0,5,21,0,0,26,142
2008,Paraguay,PRY,-,-,0,7,0,9,0,0,16,0,0,0,18,0,0,18,129
2008,Peru,PER,-,-,28,55,88,824,13,121,1129,45,58,89,1914,38,160,2304,9829
2008,Philippines,PHL,-,-,5,8,10,230,7,0,260,5,5,0,134,0,0,144,63566
2008,Papua New Guinea,PNG,-,-,0,0,0,0,0,0,0,0,0,0,0,0,0,0,54
2008,Poland,POL,-,-,6,0,12,51,5,247,321,5,5,5,49,5,282,351,2610
2008,Portugal,PRT,-,-,0,0,0,14,0,5,19,0,5,0,14,0,0,19,68
2008,Qatar,QAT,-,-,0,0,0,0,0,0,0,0,0,0,0,0,0,0,69
2008,Romania,ROU,-,-,0,6,0,74,12,124,216,6,0,5,84,0,149,244,5132
2008,South Africa,ZAF,-,-,0,0,5,30,0,5,40,0,0,0,36,0,13,49,587
2008,Russian Federation,RUS,-,-,303,702,611,2587,152,5655,10010,361,756,615,2413,100,6059,10304,210569
2008,Rwanda,RWA,-,-,2942,4185,3077,9645,246,1893,21988,2931,4331,3048,12006,361,1593,24270,78617
2008,El Salvador,SLV,-,-,30,45,49,541,56,5,726,28,45,55,767,123,11,1029,16306
2008,Saudi Arabia,SAU,-,-,0,5,0,5,0,0,10,0,0,0,12,0,0,12,733
2008,Serbia and Kosovo: S/RES/1244 (1999),SRB,-,-,749,10167,13642,69536,22618,14344,131056,828,11003,14699,70199,18198,17449,132376,437987
2008,Senegal,SEN,-,-,1231,2279,2564,1598,352,82,8106,1266,1344,1665,2575,453,117,7420,16812
2008,Seychelles,SYC,-,-,0,0,8,0,0,0,8,0,0,0,0,0,0,0,65
2008,Singapore,SGP,-,-,0,0,0,0,0,0,0,0,0,0,6,0,0,6,119
2008,Sierra Leone,SLE,-,-,1038,1668,1798,5145,366,128,10143,1033,1724,1840,6503,587,256,11943,35132
2008,Solomon Islands,SLB,-,-,0,0,0,0,0,0,0,0,0,0,0,0,0,0,51
2008,Somalia,SOM,-,-,173449,179109,118072,361194,28976,506,861306,165682,185899,126104,385299,26164,519,889667,1858864
2008,Spain,ESP,-,-,0,0,0,9,0,0,9,0,8,0,0,0,5,13,43
2008,Viet Nam,VNM,-,-,5,32,41,117,0,5042,5237,11,32,33,180,0,6261,6517,329968
2008,Saint Kitts and Nevis,KNA,-,-,0,0,0,0,0,0,0,0,0,0,8,0,0,8,8
2008,Sao Tome and Principe,STP,-,-,0,7,0,7,0,0,14,0,0,5,13,0,0,18,32
2008,Sudan,SDN,-,-,32452,49079,26743,84089,6535,504054,702952,33104,48105,27503,66498,4381,507802,687393,1638812
2008,Suriname,SUR,-,-,0,0,0,5,0,0,5,0,0,0,6,0,0,6,61
2008,Slovakia,SVK,-,-,0,5,5,24,0,57,91,0,5,0,16,0,51,72,462
2008,Slovenia,SVN,-,-,0,0,0,6,0,0,6,0,0,0,6,0,0,6,61
2008,Eswatini,SWZ,-,-,0,0,0,29,0,0,29,0,0,0,8,0,0,8,123
2008,Sweden,SWE,-,-,0,0,0,8,0,0,8,0,0,0,6,0,0,6,30
2008,Switzerland,CHE,-,-,0,0,0,0,0,0,0,0,0,0,0,0,0,0,32
2008,Syrian Arab Rep.,SYR,-,-,152,226,186,677,25,248,1514,169,253,211,1229,58,462,2382,21184
2008,United Rep. of Tanzania,TZA,-,-,0,5,0,17,5,0,27,5,8,0,42,0,10,65,4160
2008,Thailand,THA,-,-,14,23,8,145,0,0,190,13,23,8,237,5,0,286,2222
2008,Tajikistan,TJK,-,-,0,0,5,16,0,11,32,0,21,0,17,0,14,52,681
2008,Turkmenistan,TKM,-,-,5,0,0,12,0,10,27,5,0,0,15,0,5,25,845
2008,Timor-Leste,TLS,-,-,0,0,0,0,0,0,0,0,0,0,0,0,0,0,15867
2008,Togo,TGO,-,-,555,546,446,1866,117,431,3961,518,581,443,3179,51,749,5521,17853
2008,Tonga,TON,-,-,0,0,0,0,0,0,0,0,0,0,0,0,0,0,26
2008,Trinidad and Tobago,TTO,-,-,8,9,6,83,0,0,106,9,11,10,84,0,0,114,469
2008,Tunisia,TUN,-,-,10,5,6,29,0,295,345,0,10,16,111,0,659,796,2686
2008,Türkiye,TUR,-,-,631,1696,1447,4685,402,5038,13899,696,1875,1397,5118,313,10700,20099,222896
2008,United Arab Emirates,ARE,-,-,0,0,0,8,0,0,8,0,0,0,0,0,0,0,263
2008,Uganda,UGA,-,-,211,227,151,830,0,33,1452,44,192,229,1489,210,46,2210,863660
2008,Ukraine,UKR,-,-,7,0,6,181,41,423,658,0,17,9,203,8,361,598,30316
2008,Uruguay,URY,-,-,0,0,7,14,0,0,21,0,0,0,20,0,0,20,246
2008,United States of America,USA,-,-,440,295,32,53,0,0,820,469,296,35,52,0,0,852,3866
2008,Uzbekistan,UZB,-,-,37,43,40,146,6,135,407,61,67,28,148,5,103,412,8135
2008,Holy See,VAT,-,-,0,0,0,0,0,0,0,0,0,0,0,0,0,0,5
2008,Saint Vincent and the Grenadines,VCT,-,-,12,32,38,416,5,0,503,16,26,21,178,0,0,241,1492
2008,Venezuela (Bolivarian Republic of),VEN,-,-,13,28,34,155,5,0,235,12,24,35,205,5,8,289,7319
2008,Samoa,WSM,-,-,0,0,0,0,0,0,0,0,0,0,0,0,0,0,5
2008,Western Sahara,ESH,-,-,0,0,0,0,0,8,8,0,0,26,493,0,11,530,116556
2008,Yemen,YEM,-,-,11228,12971,6233,25527,570,39,56568,10402,10525,5707,16889,453,67,44043,102228
2008,Zambia,ZMB,-,-,0,5,5,12,0,0,22,0,0,0,10,0,0,10,681
2008,Zimbabwe,ZWE,-,-,76,92,85,456,26,9,744,56,59,102,659,16,12,904,51600
2008,Stateless,XXA,-,-,23,34,42,157,0,0,256,22,61,38,300,6,0,427,17103
2008,Tibetan,TIB,-,-,0,7,12,13,0,10005,10037,0,0,7,20,0,10012,10039,20139
2008,Unknown ,UNK,-,-,77,50,30,742,96,9960,10955,90,52,45,967,253,12435,13842,445790
2009,Afghanistan,AFG,-,-,44262,222723,181759,511695,31419,463,992321,47100,235559,205489,611397,52377,645,1152567,3216128
2009,Albania,ALB,-,-,21,50,147,894,76,90,1278,34,75,118,1582,66,142,2017,17293
2009,Algeria,DZA,-,-,44,99,163,585,18,56,965,49,134,186,2124,22,95,2610,9705
2009,Andorra,AND,-,-,0,0,0,0,0,0,0,0,0,0,0,0,0,0,5
2009,Angola,AGO,-,-,7988,9363,8096,31099,4298,7724,68568,7675,9206,8989,27795,1609,6897,62171,156181
2009,Antigua and Barbuda,ATG,-,-,0,0,0,25,0,0,25,0,0,5,11,0,0,16,68
2009,Egypt,EGY,-,-,23,47,47,164,24,8,313,43,70,55,708,74,32,982,8609
2009,Argentina,ARG,-,-,0,0,12,29,9,0,50,10,6,0,61,5,0,82,758
2009,Armenia,ARM,-,-,79,202,316,1620,170,26,2413,74,183,322,1745,108,36,2468,104320
2009,Australia,AUS,-,-,0,0,5,9,7,0,21,0,6,0,5,0,0,11,32
2009,Austria,AUT,-,-,0,0,0,5,0,0,5,0,0,0,0,0,5,5,15
2009,Azerbaijan,AZE,-,-,27030,36020,36949,169422,34317,30,303768,27468,33680,36195,161296,33973,34,292646,605423
2009,Bahrain,BHR,-,-,0,0,0,7,0,0,7,0,0,0,6,5,0,11,72
2009,Barbados,BRB,-,-,0,5,6,28,0,0,39,0,9,0,18,0,0,27,94
2009,Burundi,BDI,-,-,7189,8527,5004,13752,993,152,35617,8684,10185,6252,15320,883,164,41488,199066
2009,Belgium,BEL,-,-,0,5,0,0,0,0,5,0,9,0,0,0,0,9,90
2009,Benin,BEN,-,-,5,9,0,57,0,7,78,0,7,30,219,0,5,261,608
2009,Bangladesh,BGD,-,-,12,31,35,210,10,10,308,30,42,27,1281,15,10,1405,12255
2009,Bahamas,BHS,-,-,0,9,0,6,0,0,15,0,6,0,6,0,0,12,44
2009,Bhutan,BTN,-,-,3416,5099,5613,24746,2643,1119,42636,3637,5350,5750,25362,3116,1118,44333,90077
2009,Burkina Faso,BFA,-,-,5,7,12,55,0,12,91,7,13,5,234,0,15,274,1360
2009,Belarus,BLR,-,-,22,63,80,697,119,45,1026,9,62,103,691,93,63,1021,6493
2009,Bolivia (Plurinational State of),BOL,-,-,10,5,13,71,5,0,104,5,11,10,97,11,5,139,732
2009,Botswana,BWA,-,-,0,0,8,124,0,0,132,0,6,5,52,0,0,63,227
2009,Brazil,BRA,-,-,11,11,25,129,11,6,193,5,24,11,121,0,0,161,1334
2009,Bosnia and Herzegovina,BIH,-,-,1527,5693,6763,55861,19153,26722,115719,1587,5821,6854,53925,13898,25659,107744,235669
2009,Bulgaria,BGR,-,-,6,7,18,108,12,18,169,8,7,7,101,36,21,180,3177
2009,Belize,BLZ,-,-,0,0,0,0,0,0,0,0,0,0,7,0,0,7,32
2009,Cambodia,KHM,-,-,0,33,21,107,5,1445,1611,5,19,23,160,13,1425,1645,17242
2009,Canada,CAN,-,-,5,6,0,9,5,0,25,9,9,0,9,0,0,27,106
2009,Central African Rep.,CAF,-,-,24875,39299,26445,78593,4007,179,173398,27731,39528,25535,75650,4227,198,172869,357394
2009,Chad,TCD,-,-,17627,28327,13991,37880,3257,3236,104318,17571,27425,12426,24126,2916,3349,87813,227839
2009,China,CHN,-,-,134,287,232,2811,177,349,3990,174,273,236,4336,139,621,5779,198871
2009,Chile,CHL,-,-,5,10,6,177,65,32,295,0,5,20,245,75,45,390,1483
2009,Cameroon,CMR,-,-,289,242,304,1314,70,127,2346,236,233,242,1460,40,159,2370,16991
2009,Congo,COG,-,-,451,1086,885,3280,116,80,5898,439,1108,770,4375,141,231,7064,23753
2009,Dem. Rep. of the Congo,COD,-,-,28252,37350,25321,72157,3943,7870,174893,28483,36721,25516,69625,3613,8068,172026,2539633
2009,Comoros,COM,-,-,0,0,5,0,0,0,5,0,0,0,5,0,0,5,273
2009,Colombia,COL,-,-,2924,6911,6012,36866,1608,1619690,1674011,3321,7324,6705,45181,2390,1685825,1750746,3758067
2009,Costa Rica,CRI,-,-,0,7,0,21,0,0,28,0,8,6,33,0,0,47,420
2009,Cuba,CUB,-,-,13,46,90,1278,82,15,1524,29,68,116,2527,103,17,2860,9750
2009,Cabo Verde,CPV,-,-,0,0,0,0,0,0,0,0,0,0,5,0,0,5,22
2009,Cyprus,CYP,-,-,0,0,0,5,0,0,5,0,0,0,0,0,0,0,10
2009,Czechia,CZE,-,-,154,168,137,577,44,12,1092,142,160,123,650,72,12,1159,3160
2009,Denmark,DNK,-,-,0,0,0,0,0,0,0,0,0,0,0,0,0,0,10
2009,Djibouti,DJI,-,-,11,28,13,61,0,26,139,19,17,8,62,0,33,139,772
2009,Dominica,DMA,-,-,0,0,0,11,0,0,11,0,0,0,7,0,0,7,69
2009,Dominican Rep.,DOM,-,-,0,15,25,89,0,0,129,5,10,15,127,0,0,157,623
2009,Ecuador,ECU,-,-,15,19,22,76,0,6,138,5,27,26,102,0,0,160,1308
2009,Equatorial Guinea,GNQ,-,-,0,0,10,31,0,0,41,0,6,5,58,0,0,69,373
2009,Eritrea,ERI,-,-,6593,9312,7407,33320,2283,7982,66897,6985,9903,8643,46090,3178,8853,83652,223543
2009,Estonia,EST,-,-,0,0,5,29,14,0,48,0,0,5,25,8,5,43,283
2009,Ethiopia,ETH,-,-,3236,3944,2292,16664,547,2876,29559,3354,4139,2628,21820,609,2880,35430,111610
2009,Fiji,FJI,-,-,0,0,5,26,5,0,36,0,5,0,30,5,0,40,2248
2009,Finland,FIN,-,-,0,0,0,0,0,0,0,0,0,0,0,0,0,0,6
2009,France,FRA,-,-,0,5,7,20,0,0,32,5,5,8,9,0,0,27,149
2009,Gabon,GAB,-,-,0,5,11,13,0,0,29,0,0,0,18,0,0,18,178
2009,Gambia,GMB,-,-,14,6,27,108,0,9,164,10,16,36,737,9,11,819,3121
2009,Palestinian,PSE,-,-,6923,9099,6132,18215,1558,35,41962,7663,6103,11187,20409,1437,52,46851,97673
2009,United Kingdom of Great Britain and Northern Ireland,GBR,-,-,5,5,0,6,0,0,16,0,0,0,9,0,0,9,199
2009,Georgia,GEO,-,-,34,91,116,965,170,7,1383,38,92,159,1381,95,12,1777,372414
2009,Germany,DEU,-,-,6,12,0,21,0,5,44,0,9,6,15,0,0,30,248
2009,Ghana,GHA,-,-,1058,1668,669,3295,54,0,6744,1169,1085,511,3349,169,8,6291,16195
2009,Guinea-Bissau,GNB,-,-,11,0,7,28,0,13,59,0,0,42,214,0,17,273,1417
2009,Greece,GRC,-,-,0,0,0,10,0,0,10,0,0,0,17,0,0,17,82
2009,Grenada,GRD,-,-,0,0,5,56,0,0,61,0,5,0,22,0,0,27,420
2009,Guatemala,GTM,-,-,18,33,32,225,28,0,336,21,41,69,395,40,6,572,14867
2009,Guinea,GIN,-,-,38,73,69,363,0,463,1006,46,58,139,1146,12,380,1781,13731
2009,Guyana,GUY,-,-,5,8,11,100,5,0,129,0,9,9,127,5,0,150,1047
2009,Haiti,HTI,-,-,361,425,267,2554,94,8,3709,371,428,274,3416,46,0,4535,35996
2009,"China, Hong Kong SAR",HKG,-,-,0,0,0,61,0,0,61,0,0,0,5,0,0,5,76
2009,Honduras,HND,-,-,15,39,35,165,5,0,259,20,21,28,429,0,0,498,2162
2009,Croatia,HRV,-,-,62,1210,2433,22181,13276,12285,51447,62,1272,2505,26075,8716,11335,49965,102479
2009,Hungary,HUN,-,-,135,177,117,712,26,19,1186,118,186,159,854,96,99,1512,3987
2009,Iceland,ISL,-,-,0,0,0,0,0,0,0,0,0,0,0,0,0,0,5
2009,Cote d'Ivoire,CIV,-,-,1015,1373,1011,3728,203,270462,277792,965,1427,1132,6314,146,250353,260337,547550
2009,India,IND,-,-,57,59,33,444,33,7,633,58,74,104,3799,106,10,4151,24205
2009,Indonesia,IDN,-,-,76,117,93,514,28,0,828,85,128,108,368,42,0,731,20209
2009,Ireland,IRL,-,-,0,0,0,0,0,0,0,0,0,0,5,0,0,5,12
2009,Iran (Islamic Rep. of),IRN,-,-,631,1886,2032,12343,1744,407,19043,670,1962,2240,19347,1762,674,26655,86505
2009,Iraq,IRQ,-,-,174831,234333,220089,823696,97938,1294,1552181,183277,244343,231574,894078,88983,1817,1644072,3366294
2009,Israel,ISR,-,-,54,68,36,353,105,0,616,46,94,55,449,67,0,711,2352
2009,Italy,ITA,-,-,0,5,0,11,0,5,21,0,5,5,15,0,0,25,73
2009,Jamaica,JAM,-,-,0,17,13,212,7,0,249,9,19,5,231,5,0,269,1482
2009,Jordan,JOR,-,-,15,50,31,254,15,13,378,19,58,54,611,74,7,823,2866
2009,Japan,JPN,-,-,13,18,9,28,0,0,68,27,22,12,7,0,0,68,176
2009,Kazakhstan,KAZ,-,-,10,52,65,624,216,11,978,11,56,69,587,64,7,794,4344
2009,Kenya,KEN,-,-,493,798,552,1597,136,8,3584,521,732,499,1419,146,13,3330,411584
2009,Kyrgyzstan,KGZ,-,-,0,51,54,477,198,14,794,10,32,77,424,129,11,683,3038
2009,Kiribati,KIR,-,-,0,0,0,0,0,0,0,0,0,0,0,0,0,0,31
2009,Rep. of Korea,KOR,-,-,10,49,41,142,10,0,252,16,52,41,116,10,0,235,885
2009,Dem. People's Rep. of Korea,PRK,-,-,9,0,0,97,5,5,116,0,6,7,117,0,8,138,1003
2009,Kuwait,KWT,-,-,5,5,0,47,8,0,65,0,7,11,107,9,0,134,992
2009,Lao People's Dem. Rep.,LAO,-,-,22,42,30,139,17,79,329,29,42,31,192,14,106,414,8587
2009,Liberia,LBR,-,-,2658,5946,4512,19023,799,100,33038,2736,5873,4465,18265,858,160,32357,73796
2009,Libya,LBY,-,-,35,26,31,144,9,110,355,25,37,20,371,34,169,656,2825
2009,Saint Lucia,LCA,-,-,16,22,23,299,0,0,360,12,23,14,188,0,0,237,909
2009,Lebanon,LBN,-,-,142,402,640,4330,577,19,6110,173,465,690,6125,563,43,8059,18005
2009,Lesotho,LSO,-,-,0,0,0,5,0,0,5,0,0,0,0,0,0,0,10
2009,Sri Lanka,LKA,-,-,270,623,526,5001,755,36042,43217,265,651,739,12824,787,37916,53182,588177
2009,Lithuania,LTU,-,-,0,8,23,86,21,7,145,0,12,14,100,18,11,155,606
2009,Latvia,LVA,-,-,0,21,20,158,89,5,293,0,13,30,144,69,0,256,863
2009,"China, Macao SAR",MAC,-,-,0,0,0,0,0,0,0,0,0,0,0,0,0,0,8
2009,Madagascar,MDG,-,-,0,0,0,25,0,0,25,0,0,5,11,0,0,16,302
2009,Mauritania,MRT,-,-,2484,3556,2505,6939,624,22,16130,2755,3109,2565,7029,701,267,16426,40025
2009,North Macedonia,MKD,-,-,49,186,315,2064,74,10,2698,56,221,333,3137,65,30,3842,8789
2009,Rep. of Moldova,MDA,-,-,12,70,152,1329,674,0,2237,10,73,135,1296,483,6,2003,6662
2009,Maldives,MDV,-,-,0,0,0,0,0,0,0,0,0,0,0,0,5,5,15
2009,Mexico,MEX,-,-,536,710,522,4298,35,0,6101,547,760,486,5985,38,0,7816,26835
2009,Mali,MLI,-,-,5,5,7,31,0,5,53,5,10,0,112,5,0,132,3686
2009,Malaysia,MYS,-,-,0,5,5,23,0,0,33,0,0,5,31,0,5,41,678
2009,Malawi,MWI,-,-,0,0,0,7,0,0,7,0,0,0,5,0,0,5,168
2009,Mongolia,MNG,-,-,15,24,24,195,0,0,258,14,21,10,169,0,0,214,3781
2009,Morocco,MAR,-,-,24,31,34,427,24,11,551,16,38,43,1255,27,19,1398,2880
2009,Mozambique,MOZ,-,-,0,11,0,20,0,0,31,0,0,10,66,0,0,76,135
2009,Malta,MLT,-,-,0,0,0,0,0,0,0,0,0,0,0,0,0,0,10
2009,Montenegro,MNE,-,-,58,147,190,764,24,5,1188,46,129,228,964,23,0,1390,2751
2009,Mauritius,MUS,-,-,0,0,0,5,0,0,5,0,0,0,0,0,0,0,37
2009,Myanmar,MMR,-,-,13421,15921,12956,49831,3118,370,95617,14060,16720,14702,75426,3201,839,124948,496541
2009,Namibia,NAM,-,-,42,47,31,152,0,0,272,53,51,22,527,9,0,662,961
2009,Nepal,NPL,-,-,0,23,9,198,9,15,254,5,20,18,616,10,15,684,6905
2009,Netherlands (Kingdom of the),NLD,-,-,0,0,7,13,0,0,20,0,7,0,0,0,0,7,69
2009,Niger,NER,-,-,11,14,5,47,0,17,94,10,6,12,220,0,8,256,1095
2009,Nicaragua,NIC,-,-,12,33,45,344,31,0,465,17,43,48,477,30,0,615,1903
2009,Nigeria,NGA,-,-,372,480,483,2483,72,11,3901,379,539,468,4878,103,13,6380,25246
2009,Norway,NOR,-,-,0,0,0,5,0,0,5,0,0,0,0,0,0,0,5
2009,New Zealand,NZL,-,-,0,0,0,0,0,0,0,0,0,9,0,0,0,9,9
2009,Oman,OMN,-,-,0,0,5,17,0,0,22,5,7,0,13,0,0,25,68
2009,Pakistan,PAK,-,-,190,417,366,2172,286,909430,912861,189,464,375,5407,401,985252,992088,1934442
2009,Panama,PAN,-,-,0,0,9,23,0,0,32,0,0,7,20,0,0,27,143
2009,Paraguay,PRY,-,-,0,6,0,13,0,0,19,0,0,0,15,0,0,15,107
2009,Peru,PER,-,-,40,87,126,1587,40,5,1885,60,92,152,4439,83,5,4831,12078
2009,Philippines,PHL,-,-,0,11,16,316,16,0,359,0,15,19,180,13,0,227,63091
2009,Papua New Guinea,PNG,-,-,0,0,0,0,0,0,0,0,0,0,0,0,0,0,79
2009,Poland,POL,-,-,22,47,63,263,61,137,593,21,49,42,275,82,175,644,2297
2009,Portugal,PRT,-,-,0,0,6,14,0,5,25,0,11,0,15,0,0,26,76
2009,Qatar,QAT,-,-,0,5,0,12,0,0,17,0,8,0,35,0,0,43,71
2009,Romania,ROU,-,-,11,35,29,267,131,30,503,10,28,28,296,85,44,491,4762
2009,South Africa,ZAF,-,-,0,5,11,41,0,0,57,5,0,8,57,15,0,85,542
2009,Russian Federation,RUS,-,-,613,1840,1895,13637,7278,1681,26944,671,1918,2017,12332,5107,1903,23948,202994
2009,Rwanda,RWA,-,-,2992,4390,2948,9716,308,858,21212,2981,4379,2942,12114,428,815,23659,133900
2009,El Salvador,SLV,-,-,32,55,45,570,66,0,768,39,44,76,913,143,0,1215,14797
2009,Saudi Arabia,SAU,-,-,13,17,9,96,19,0,154,8,25,13,174,18,0,238,672
2009,Serbia and Kosovo: S/RES/1244 (1999),SRB,-,-,2171,15925,22562,107630,24271,10698,183257,2374,16925,23817,121626,19990,12403,197135,443189
2009,Senegal,SEN,-,-,1235,2382,2637,1557,399,14,8224,1266,1464,1769,2379,467,37,7382,16922
2009,Seychelles,SYC,-,-,0,0,7,0,0,0,7,0,0,0,0,0,0,0,54
2009,Singapore,SGP,-,-,0,0,0,9,0,0,9,0,0,0,5,0,0,5,89
2009,Sierra Leone,SLE,-,-,351,595,684,1480,105,1485,4700,315,646,711,2714,426,1962,6774,23003
2009,Solomon Islands,SLB,-,-,0,0,0,0,0,0,0,0,0,0,0,0,0,0,65
2009,Somalia,SOM,-,-,214434,221974,141458,439665,35249,230,1053010,205749,229476,150264,466590,31625,333,1084037,2249355
2009,Spain,ESP,-,-,5,0,0,13,0,0,18,0,5,0,28,0,5,38,85
2009,Viet Nam,VNM,-,-,122,297,1220,9553,786,977,12955,111,357,1264,12123,483,1422,15760,340558
2009,Saint Kitts and Nevis,KNA,-,-,0,0,0,5,0,0,5,0,0,0,6,0,0,6,11
2009,Sao Tome and Principe,STP,-,-,0,7,0,7,0,0,14,0,0,5,13,0,0,18,32
2009,Sudan,SDN,-,-,30298,42886,23937,76376,6614,517160,697271,30675,41865,23171,54914,4354,517487,672466,1419219
2009,Suriname,SUR,-,-,0,0,0,7,0,0,7,0,0,0,0,0,0,0,56
2009,Slovakia,SVK,-,-,19,17,22,117,5,5,185,20,28,22,104,8,0,182,684
2009,Slovenia,SVN,-,-,0,0,0,15,0,0,15,0,0,0,16,0,0,16,51
2009,Eswatini,SWZ,-,-,0,0,0,37,0,0,37,0,0,0,16,0,0,16,81
2009,Sweden,SWE,-,-,0,0,0,6,0,0,6,0,6,0,0,0,0,6,27
2009,Switzerland,CHE,-,-,0,0,0,5,0,0,5,0,5,0,0,0,0,5,24
2009,Syrian Arab Rep.,SYR,-,-,478,852,924,3811,328,160,6553,481,1052,1002,5779,359,264,8937,23474
2009,United Rep. of Tanzania,TZA,-,-,7,10,6,31,5,5,64,10,13,16,88,0,9,136,156446
2009,Thailand,THA,-,-,13,40,35,228,5,0,321,15,36,45,291,10,0,397,890
2009,Tajikistan,TJK,-,-,0,11,10,74,19,0,114,11,30,15,106,7,0,169,816
2009,Turkmenistan,TKM,-,-,10,6,9,88,22,0,135,5,9,12,88,14,0,128,811
2009,Timor-Leste,TLS,-,-,0,0,0,0,0,0,0,0,0,0,0,0,0,0,7
2009,Togo,TGO,-,-,549,898,709,3167,72,282,5677,556,943,634,5572,75,359,8139,19322
2009,Tonga,TON,-,-,0,0,0,0,0,0,0,0,0,0,0,0,0,0,26
2009,Trinidad and Tobago,TTO,-,-,5,5,10,101,0,0,121,8,6,19,94,0,0,127,510
2009,Tunisia,TUN,-,-,16,28,7,173,7,222,453,15,36,26,852,15,385,1329,2725
2009,Türkiye,TUR,-,-,1215,4644,6662,30006,3501,1722,47750,1297,4974,7041,55713,3227,2878,75130,155651
2009,United Arab Emirates,ARE,-,-,9,15,8,118,16,0,166,19,18,18,141,17,0,213,433
2009,Uganda,UGA,-,-,122,198,159,1168,0,22,1669,48,115,162,1688,167,17,2197,454741
2009,Ukraine,UKR,-,-,81,399,887,5916,2279,52,9614,66,436,978,6024,1881,42,9427,26042
2009,Uruguay,URY,-,-,0,0,8,17,5,0,30,0,5,0,29,0,0,34,243
2009,United States of America,USA,-,-,381,291,71,89,18,0,850,407,322,77,83,7,0,896,3810
2009,Uzbekistan,UZB,-,-,39,106,143,913,113,36,1350,44,159,135,880,88,39,1345,8238
2009,Saint Vincent and the Grenadines,VCT,-,-,16,42,42,556,6,0,662,19,29,34,328,0,0,410,1919
2009,Venezuela (Bolivarian Republic of),VEN,-,-,18,60,41,229,5,0,353,18,37,44,271,10,0,380,7787
2009,Western Sahara,ESH,-,-,0,0,0,0,0,8,8,0,0,5,450,0,0,455,116489
2009,Yemen,YEM,-,-,28095,32442,15541,63666,1418,59,141221,26009,26300,14295,42131,1118,73,109926,252529
2009,Zambia,ZMB,-,-,0,5,0,16,0,0,21,0,0,0,19,0,0,19,247
2009,Zimbabwe,ZWE,-,-,86,88,74,534,37,5,824,68,71,103,769,19,0,1030,23835
2009,Stateless,XXA,-,-,79,219,310,1523,254,0,2385,90,249,321,2546,322,0,3528,19249
2009,Tibetan,TIB,-,-,0,0,0,0,0,10005,10005,0,0,0,0,0,10010,10010,20189
2009,Unknown ,UNK,-,-,586,1045,935,4147,513,2123,9349,577,1096,1052,6711,694,3573,13703,634391
2010,Afghanistan,AFG,-,-,182531,385902,235791,652443,39416,1953,1498036,190785,403475,270313,724878,68765,4425,1662641,4283030
2010,Albania,ALB,-,-,14,52,117,867,74,839,1963,25,65,115,1492,72,991,2760,16157
2010,Algeria,DZA,-,-,33,98,151,636,13,523,1454,38,136,165,2104,33,892,3368,8379
2010,Andorra,AND,-,-,0,0,0,0,0,0,0,0,0,0,0,0,0,0,5
2010,Angola,AGO,-,-,7310,12347,8290,28027,3993,1357,61324,7283,12506,8649,26422,3764,1990,60614,135561
2010,Antigua and Barbuda,ATG,-,-,0,0,0,15,0,5,20,0,0,0,12,0,0,12,60
2010,Egypt,EGY,-,-,37,83,63,205,27,71,486,42,78,74,755,85,160,1194,8474
2010,Argentina,ARG,-,-,0,0,15,36,0,0,51,10,7,5,54,0,0,76,637
2010,Armenia,ARM,-,-,54,211,284,1677,185,1971,4382,78,194,279,1766,130,2046,4493,103019
2010,Australia,AUS,-,-,0,0,7,10,7,0,24,0,0,6,13,0,0,19,48
2010,Austria,AUT,-,-,0,0,0,0,0,0,0,0,0,0,0,0,5,5,10
2010,Azerbaijan,AZE,-,-,27335,36414,37347,171281,34730,1347,308454,27756,34054,36580,162927,34404,1281,297002,611688
2010,Bahrain,BHR,-,-,0,5,0,21,0,0,26,0,0,5,17,0,0,22,105
2010,Barbados,BRB,-,-,0,0,6,24,0,0,30,0,7,0,26,0,0,33,92
2010,Burundi,BDI,-,-,7178,8783,5876,14093,574,487,36991,7149,8668,6079,15186,611,521,38214,248714
2010,Belgium,BEL,-,-,0,0,0,6,0,0,6,0,6,0,0,0,0,6,86
2010,Benin,BEN,-,-,0,19,7,62,0,16,104,0,12,21,246,0,26,305,663
2010,Bangladesh,BGD,-,-,16,21,40,211,15,263,566,25,31,41,1370,21,2195,3683,16538
2010,Bahamas,BHS,-,-,0,0,8,7,0,0,15,0,7,0,6,0,0,13,45
2010,Bhutan,BTN,-,-,2954,4076,4608,20768,2293,1120,35819,3147,4266,4824,21331,2785,1163,37516,76071
2010,Burkina Faso,BFA,-,-,10,10,11,56,0,43,130,5,13,5,241,0,96,360,1640
2010,Belarus,BLR,-,-,11,55,75,753,145,268,1307,6,65,94,732,102,402,1401,6472
2010,Bolivia (Plurinational State of),BOL,-,-,5,5,18,80,0,24,132,0,6,12,98,8,25,149,723
2010,Botswana,BWA,-,-,0,5,5,114,0,0,124,0,5,5,46,0,0,56,241
2010,Brazil,BRA,-,-,10,21,23,103,13,15,185,0,26,16,121,0,0,163,1232
2010,Bosnia and Herzegovina,BIH,-,-,1474,5278,6216,53775,18915,29196,114854,1475,5416,6475,52187,13812,30440,109805,230591
2010,Bulgaria,BGR,-,-,12,12,11,107,16,47,205,10,12,10,84,37,61,214,2682
2010,Belize,BLZ,-,-,0,0,0,0,0,0,0,0,5,0,0,0,0,5,31
2010,Cambodia,KHM,-,-,0,33,5,104,10,7754,7906,6,22,33,121,16,7609,7807,16445
2010,Canada,CAN,-,-,10,6,0,7,5,0,28,5,7,5,6,0,0,23,91
2010,Central African Rep.,CAF,-,-,23649,39571,30935,81100,4796,706,180757,25648,38679,28983,71800,4747,801,170658,358935
2010,Chad,TCD,-,-,736,1195,861,3559,189,3384,9924,739,1109,793,6102,265,3999,13007,187377
2010,China,CHN,-,-,149,287,230,2905,147,887,4605,144,281,220,4450,139,1400,6634,192333
2010,Chile,CHL,-,-,0,14,13,168,69,38,302,0,6,10,239,84,44,383,1333
2010,Cameroon,CMR,-,-,294,315,249,1329,78,442,2707,235,272,212,1510,36,775,3040,17029
2010,Congo,COG,-,-,244,1081,1002,3304,131,1728,7490,253,1074,1037,4251,145,1903,8663,23681
2010,Dem. Rep. of the Congo,COD,-,-,42570,52287,32415,99581,6315,13365,246533,42461,52164,31970,92112,4878,14519,238104,2241155
2010,Comoros,COM,-,-,0,0,5,0,0,100,105,0,6,0,5,0,224,235,370
2010,Colombia,COL,-,-,3264,7197,6762,38805,1753,1818022,1875803,3587,7698,7352,44710,2440,1856717,1922504,4127969
2010,Costa Rica,CRI,-,-,0,7,0,23,0,0,30,0,0,9,44,0,0,53,426
2010,Cuba,CUB,-,-,14,46,88,1955,85,131,2319,33,67,121,3919,118,213,4471,11840
2010,Cabo Verde,CPV,-,-,0,0,0,0,0,0,0,0,0,0,5,0,0,5,22
2010,Cyprus,CYP,-,-,0,0,0,5,0,0,5,0,0,0,0,0,0,0,10
2010,Czechia,CZE,-,-,80,89,89,329,38,11,636,79,101,59,375,63,11,688,1963
2010,Denmark,DNK,-,-,0,0,0,0,0,0,0,0,0,0,0,0,0,0,6
2010,Djibouti,DJI,-,-,23,28,9,74,13,79,226,30,22,9,62,5,83,211,782
2010,Dominica,DMA,-,-,0,0,0,9,0,0,9,0,0,0,7,0,0,7,67
2010,Dominican Rep.,DOM,-,-,0,13,22,98,0,0,133,0,10,21,140,0,0,171,624
2010,Ecuador,ECU,-,-,20,27,13,68,0,5,133,5,37,16,106,0,0,164,1060
2010,Equatorial Guinea,GNQ,-,-,0,0,10,31,0,26,67,0,12,10,72,0,29,123,378
2010,Eritrea,ERI,-,-,7764,11353,8699,38499,2585,12825,81725,8252,12055,10358,49672,3588,14732,98657,236026
2010,Estonia,EST,-,-,0,0,5,32,17,0,54,0,0,5,30,10,5,50,257
2010,Ethiopia,ETH,-,-,3360,4413,2889,18316,660,14285,43923,3507,4672,3250,24344,674,10613,47060,117728
2010,Fiji,FJI,-,-,0,0,7,24,0,0,31,0,0,7,36,5,0,48,2147
2010,Finland,FIN,-,-,0,0,0,0,0,0,0,0,0,0,0,0,0,0,6
2010,France,FRA,-,-,5,0,13,11,0,0,29,0,0,8,7,0,0,15,123
2010,Gabon,GAB,-,-,0,5,5,10,0,15,35,5,0,0,25,0,12,42,204
2010,Gambia,GMB,-,-,17,10,23,124,0,64,238,11,7,49,798,10,150,1025,3277
2010,Palestinian,PSE,-,-,6808,8990,5959,17338,1496,130,40721,7539,6049,11081,19491,1291,330,45781,96506
2010,United Kingdom of Great Britain and Northern Ireland,GBR,-,-,0,0,18,8,0,0,26,0,0,6,9,0,0,15,195
2010,Georgia,GEO,-,-,35,95,111,986,178,1255,2660,36,70,145,1326,99,1273,2949,377537
2010,Germany,DEU,-,-,0,5,0,9,0,5,19,0,0,0,11,0,0,11,189
2010,Ghana,GHA,-,-,1384,2012,824,4565,473,238,9496,1330,2122,989,4312,516,512,9781,22171
2010,Guinea-Bissau,GNB,-,-,6,0,6,34,0,300,346,0,0,29,207,0,661,897,1455
2010,Greece,GRC,-,-,0,0,6,8,0,0,14,0,5,0,17,0,0,22,88
2010,Grenada,GRD,-,-,0,0,5,37,0,0,42,0,0,0,21,0,0,21,407
2010,Guatemala,GTM,-,-,34,43,32,270,15,8,402,24,45,47,456,24,5,601,6698
2010,Guinea,GIN,-,-,63,71,79,385,0,2220,2818,37,62,138,1436,11,2506,4190,14747
2010,Guyana,GUY,-,-,0,6,0,57,0,0,63,0,6,0,91,0,0,97,916
2010,Haiti,HTI,-,-,195,248,175,1614,113,2682,5027,209,251,181,2504,57,3135,6337,33076
2010,"China, Hong Kong SAR",HKG,-,-,0,0,0,75,0,0,75,0,0,0,6,0,0,6,97
2010,Honduras,HND,-,-,18,37,27,194,5,8,289,25,28,35,419,5,10,522,2115
2010,Croatia,HRV,-,-,34,632,2169,19142,12314,10634,44925,35,675,2217,22632,7669,9809,43037,88779
2010,Hungary,HUN,-,-,194,232,194,1048,33,44,1745,177,260,217,1216,106,121,2097,4983
2010,Iceland,ISL,-,-,0,0,0,0,0,0,0,0,0,0,0,0,0,0,5
2010,Cote d'Ivoire,CIV,-,-,3278,4009,2248,7361,688,1295,18879,3158,4261,2517,7948,364,2778,21026,562276
2010,India,IND,-,-,62,59,30,785,38,137,1111,61,75,99,3844,118,219,4416,22050
2010,Indonesia,IDN,-,-,75,113,94,417,28,5,732,82,132,106,360,41,5,726,17333
2010,Ireland,IRL,-,-,0,0,0,0,0,0,0,0,0,0,0,0,0,0,7
2010,Iran (Islamic Rep. of),IRN,-,-,628,1566,1727,11313,1644,1396,18274,775,1722,1967,18372,1673,2547,27056,84840
2010,Iraq,IRQ,-,-,155899,209861,195221,737523,92715,3340,1394559,163632,221222,203460,823479,49455,42544,1503792,3063792
2010,Israel,ISR,-,-,29,52,38,264,99,5,487,40,60,38,344,68,0,550,2082
2010,Italy,ITA,-,-,0,5,0,24,0,5,34,0,8,0,21,0,0,29,97
2010,Jamaica,JAM,-,-,0,13,20,218,5,0,256,6,14,12,247,7,7,293,1609
2010,Jordan,JOR,-,-,10,65,43,226,20,18,382,19,77,68,576,85,23,848,2858
2010,Japan,JPN,-,-,13,16,10,19,5,0,63,20,23,11,11,0,0,65,159
2010,Kazakhstan,KAZ,-,-,12,50,61,644,228,299,1294,20,58,75,611,67,270,1101,4380
2010,Kenya,KEN,-,-,381,574,363,1312,109,50,2789,422,547,339,1049,115,45,2517,310234
2010,Kyrgyzstan,KGZ,-,-,16,52,83,581,226,42723,43681,47,46,88,661,154,37532,38528,84308
2010,Kiribati,KIR,-,-,0,0,0,0,0,0,0,0,0,0,0,0,0,0,31
2010,Rep. of Korea,KOR,-,-,12,28,46,116,5,0,207,16,40,38,100,5,0,199,811
2010,Dem. People's Rep. of Korea,PRK,-,-,11,9,5,145,6,15,191,9,11,5,143,5,12,185,1183
2010,Kuwait,KWT,-,-,5,18,0,51,10,0,84,0,14,12,109,10,0,145,1067
2010,Lao People's Dem. Rep.,LAO,-,-,13,37,28,130,17,3659,3884,25,48,32,167,18,3978,4268,8480
2010,Liberia,LBR,-,-,3125,6051,5059,17743,601,237,32816,3060,6119,4891,16810,732,418,32030,72042
2010,Libya,LBY,-,-,29,28,40,160,20,105,382,30,51,22,399,45,259,806,2855
2010,Saint Lucia,LCA,-,-,14,24,27,340,0,0,405,20,28,22,208,0,0,278,1017
2010,Lebanon,LBN,-,-,123,363,558,4111,608,56,5819,169,455,631,5808,594,159,7816,17382
2010,Lesotho,LSO,-,-,0,0,0,5,0,0,5,0,0,0,0,0,0,0,10
2010,Sri Lanka,LKA,-,-,285,583,524,5121,810,182055,189378,283,603,641,14186,905,185141,201759,423424
2010,Lithuania,LTU,-,-,10,13,18,100,35,6,182,0,18,6,114,25,11,174,628
2010,Latvia,LVA,-,-,7,26,25,182,97,5,342,5,24,24,180,69,0,302,889
2010,"China, Macao SAR",MAC,-,-,0,0,0,0,0,0,0,0,0,0,0,0,0,0,8
2010,Madagascar,MDG,-,-,0,5,0,9,0,103,117,0,0,0,8,0,114,122,284
2010,Mauritania,MRT,-,-,2320,3557,2223,6605,604,988,16297,2591,3103,2330,6838,681,3895,19438,38474
2010,North Macedonia,MKD,-,-,171,369,400,2576,88,167,3771,187,390,454,3563,74,206,4874,10722
2010,Rep. of Moldova,MDA,-,-,10,58,146,1397,744,206,2561,10,58,141,1313,533,201,2256,6839
2010,Maldives,MDV,-,-,0,0,0,0,0,0,0,0,0,0,0,0,5,5,16
2010,Mexico,MEX,-,-,358,473,347,2877,29,5,4089,351,521,348,4043,24,11,5298,16765
2010,Mali,MLI,-,-,0,13,0,41,0,1897,1951,5,10,5,111,5,780,916,4044
2010,Malaysia,MYS,-,-,0,0,7,18,0,0,25,0,0,0,25,0,5,30,666
2010,Malawi,MWI,-,-,0,0,0,8,0,0,8,0,0,0,6,0,0,6,228
2010,Mongolia,MNG,-,-,14,9,29,199,0,267,518,17,13,15,137,0,228,410,3508
2010,Morocco,MAR,-,-,20,45,34,403,28,65,595,23,40,52,1256,33,165,1569,3108
2010,Mozambique,MOZ,-,-,0,15,0,15,0,0,30,0,0,11,72,0,0,83,131
2010,Malta,MLT,-,-,0,0,0,0,0,0,0,0,0,0,0,0,0,0,5
2010,Montenegro,MNE,-,-,53,171,219,1039,41,35,1558,41,143,265,1211,34,14,1708,3424
2010,Mauritius,MUS,-,-,0,0,0,0,0,0,0,0,0,0,0,0,0,0,65
2010,Myanmar,MMR,-,-,13451,16867,14990,62297,6097,543,114245,13659,17342,15922,98302,5474,1142,151841,499945
2010,Namibia,NAM,-,-,10,9,6,175,0,0,200,7,5,6,137,0,0,155,1358
2010,Nepal,NPL,-,-,0,13,12,150,9,33,217,10,16,19,544,10,141,740,7043
2010,Netherlands (Kingdom of the),NLD,-,-,9,0,0,13,0,0,22,0,8,0,0,0,0,8,73
2010,Niger,NER,-,-,6,16,8,52,0,24,106,5,5,16,260,0,55,341,1113
2010,Nicaragua,NIC,-,-,17,27,54,329,31,14,472,24,36,41,470,20,9,600,1580
2010,Nigeria,NGA,-,-,295,496,479,2388,72,882,4612,282,585,459,5170,109,1166,7771,27557
2010,New Zealand,NZL,-,-,0,0,5,0,0,0,5,0,0,6,0,0,0,6,11
2010,Oman,OMN,-,-,0,5,6,10,0,0,21,0,7,0,15,5,0,27,68
2010,Pakistan,PAK,-,-,10840,14007,5873,23771,1456,186,56133,11174,16128,7579,26335,1968,897,64081,1012012
2010,Panama,PAN,-,-,0,5,7,18,0,0,30,0,0,8,21,0,5,34,145
2010,Paraguay,PRY,-,-,0,0,0,13,0,0,13,0,0,0,12,0,0,12,110
2010,Peru,PER,-,-,31,75,95,1357,38,122,1718,48,92,138,3798,87,163,4326,10598
2010,Philippines,PHL,-,-,0,6,20,259,25,0,310,0,11,20,184,16,0,231,221123
2010,Papua New Guinea,PNG,-,-,0,0,0,0,0,0,0,0,0,0,0,0,0,0,130
2010,Poland,POL,-,-,17,40,57,264,61,117,556,16,56,45,262,88,169,636,1911
2010,Portugal,PRT,-,-,0,5,9,21,0,0,35,0,13,0,22,0,0,35,89
2010,Qatar,QAT,-,-,0,5,0,30,5,0,40,6,5,0,53,0,0,64,116
2010,Romania,ROU,-,-,14,36,23,228,115,108,524,12,34,28,261,79,139,553,4234
2010,South Africa,ZAF,-,-,0,12,5,36,0,0,53,0,5,10,70,10,5,100,584
2010,Russian Federation,RUS,-,-,526,1354,1548,12610,7949,6696,30683,532,1498,1632,11365,5550,6775,27352,198089
2010,Rwanda,RWA,-,-,8069,9958,11364,19791,953,2218,52353,8714,10810,14515,22402,1105,1951,59497,125821
2010,El Salvador,SLV,-,-,45,54,72,527,47,13,758,31,50,76,848,82,5,1092,6521
2010,Saudi Arabia,SAU,-,-,5,28,15,105,19,0,172,10,21,8,177,21,0,237,734
2010,Serbia and Kosovo: S/RES/1244 (1999),SRB,-,-,3308,16069,22875,113006,26755,5813,187826,3557,17100,23993,127574,22365,6960,201549,436508
2010,Senegal,SEN,-,-,1414,1631,882,3628,473,263,8291,1440,1734,999,2758,211,561,7703,17777
2010,Seychelles,SYC,-,-,0,0,0,0,0,0,0,0,0,0,0,0,0,0,47
2010,Singapore,SGP,-,-,0,0,0,13,0,0,13,0,0,0,5,0,0,5,84
2010,Sierra Leone,SLE,-,-,48,100,137,386,28,281,980,57,139,157,1035,17,1052,2457,14518
2010,Solomon Islands,SLB,-,-,0,0,0,0,0,0,0,0,0,0,0,0,0,0,75
2010,Somalia,SOM,-,-,212008,221143,142281,451918,30975,1673,1059998,202107,236310,150859,466876,30145,2560,1088857,2256732
2010,Spain,ESP,-,-,0,19,0,18,0,0,37,0,5,0,26,0,5,36,111
2010,Viet Nam,VNM,-,-,96,266,918,9586,828,148820,160514,126,287,925,12340,532,163029,177239,339898
2010,Saint Kitts and Nevis,KNA,-,-,0,0,0,6,0,0,6,0,0,0,6,0,0,6,22
2010,Sao Tome and Principe,STP,-,-,0,0,7,7,0,0,14,0,0,5,13,0,0,18,32
2010,Sudan,SDN,-,-,31147,43235,31234,86431,7646,812954,1012647,31616,42609,30782,62088,5094,813580,985769,2035064
2010,Suriname,SUR,-,-,0,0,0,5,0,5,10,0,0,0,0,0,0,0,34
2010,Slovakia,SVK,-,-,27,21,31,142,5,5,231,27,32,22,137,6,0,224,581
2010,Slovenia,SVN,-,-,0,0,0,14,0,0,14,0,0,0,15,0,0,15,50
2010,Eswatini,SWZ,-,-,0,0,0,21,0,0,21,0,0,5,19,0,0,24,82
2010,Sweden,SWE,-,-,0,8,0,7,0,0,15,0,13,0,0,0,0,13,51
2010,Switzerland,CHE,-,-,0,0,0,5,0,0,5,0,0,0,0,0,0,0,20
2010,Syrian Arab Rep.,SYR,-,-,581,1008,1023,4271,369,323,7575,646,1115,1156,6436,369,749,10471,28190
2010,United Rep. of Tanzania,TZA,-,-,9671,20205,14208,35993,3135,9,83221,9697,19850,13098,33613,2968,30,79256,163585
2010,Thailand,THA,-,-,13,13,32,135,5,0,198,17,26,18,140,6,0,207,568
2010,Tajikistan,TJK,-,-,15,15,6,58,19,23,136,18,29,37,128,8,30,250,897
2010,Turkmenistan,TKM,-,-,0,10,6,77,28,10,131,0,9,17,84,12,6,128,770
2010,Timor-Leste,TLS,-,-,0,0,0,0,0,0,0,0,0,0,0,0,0,0,8
2010,Togo,TGO,-,-,592,893,744,3157,74,535,5995,587,921,679,5409,73,880,8549,19331
2010,Tonga,TON,-,-,0,0,0,0,0,0,0,0,0,0,0,0,0,0,15
2010,Trinidad and Tobago,TTO,-,-,5,5,7,58,0,0,75,0,5,10,51,0,0,66,398
2010,Tunisia,TUN,-,-,12,33,23,179,7,252,506,10,30,25,859,20,596,1540,2696
2010,Türkiye,TUR,-,-,2022,4528,6660,28785,4227,4807,51029,2255,4799,7076,54183,4251,11062,83626,154278
2010,United Arab Emirates,ARE,-,-,16,8,6,121,29,0,180,11,9,20,156,15,0,211,442
2010,Uganda,UGA,-,-,62,108,113,477,15,547,1322,77,102,104,664,27,569,1543,132948
2010,Ukraine,UKR,-,-,62,366,839,6236,2559,491,10553,55,403,925,6398,2067,464,10312,26352
2010,Uruguay,URY,-,-,5,0,0,22,0,0,27,0,0,8,19,5,5,37,234
2010,United States of America,USA,-,-,196,202,51,94,21,12,576,232,213,73,102,11,0,631,3885
2010,Uzbekistan,UZB,-,-,25,102,140,962,145,222,1596,33,121,169,938,99,189,1549,10453
2010,Saint Vincent and the Grenadines,VCT,-,-,13,46,52,508,6,0,625,17,41,45,314,5,0,422,1993
2010,Venezuela (Bolivarian Republic of),VEN,-,-,14,53,63,213,6,10,359,27,32,38,274,10,11,392,7323
2010,Western Sahara,ESH,-,-,0,0,0,7,0,0,7,0,0,0,406,0,17,423,116435
2010,Yemen,YEM,-,-,15039,28898,17525,45306,3225,68,110061,14826,31217,19923,42779,3366,85,112196,223678
2010,Zambia,ZMB,-,-,0,5,0,15,0,0,20,0,0,0,16,0,0,16,263
2010,Zimbabwe,ZWE,-,-,13,29,16,218,10,18,304,12,27,15,294,5,40,393,25081
2010,Stateless,XXA,-,-,82,176,296,1561,269,122,2506,97,200,322,2518,327,263,3727,21063
2010,Tibetan,TIB,-,-,0,0,0,0,0,0,0,0,0,0,0,0,159,159,15224
2010,Unknown ,UNK,-,-,528,988,936,4137,493,2826,9908,509,1032,961,6747,566,4563,14378,438672
2011,Afghanistan,AFG,-,-,204351,372517,243490,665697,40066,1226,1527347,215187,388319,275097,700130,68439,2435,1649607,4103700
2011,Albania,ALB,-,-,19,66,104,1181,112,870,2352,21,64,135,1791,133,1052,3196,16358
2011,Algeria,DZA,-,-,33,109,128,640,12,541,1463,34,113,152,2295,40,818,3452,8276
2011,Andorra,AND,-,-,0,0,0,0,0,0,0,0,0,0,0,0,0,0,5
2011,Angola,AGO,-,-,6669,11988,8002,27083,3910,1348,59000,6720,12141,8427,25351,3708,1965,58312,129430
2011,Antigua and Barbuda,ATG,-,-,0,0,5,21,0,0,26,5,0,0,13,0,0,18,64
2011,Egypt,EGY,-,-,45,110,71,310,71,77,684,57,101,104,960,119,161,1502,10535
2011,Argentina,ARG,-,-,0,5,11,26,5,0,47,0,14,0,35,0,5,54,560
2011,Armenia,ARM,-,-,52,176,275,1765,219,1710,4197,79,201,288,1897,142,1718,4325,102081
2011,Australia,AUS,-,-,0,0,7,11,7,0,25,0,6,0,7,0,0,13,43
2011,Austria,AUT,-,-,0,0,0,0,0,0,0,0,5,0,0,0,0,5,10
2011,Azerbaijan,AZE,-,-,27630,36795,37763,172973,35061,1300,311522,28070,34407,36963,164536,34782,1211,299969,617548
2011,Bahrain,BHR,-,-,0,5,0,11,5,0,21,0,5,0,15,5,0,25,285
2011,Barbados,BRB,-,-,0,6,5,44,0,0,55,0,9,9,37,0,0,55,115
2011,Burundi,BDI,-,-,17837,30612,22256,55803,4173,42049,172730,17999,30744,21465,56079,4141,37407,167835,352079
2011,Belgium,BEL,-,-,0,0,0,0,0,0,0,0,6,0,0,0,0,6,88
2011,Benin,BEN,-,-,0,22,21,73,0,15,131,0,11,13,230,0,16,270,729
2011,Bermuda,BMU,-,-,0,0,0,0,0,0,0,5,0,0,0,0,0,5,5
2011,Bangladesh,BGD,-,-,17,27,46,295,15,287,687,26,43,33,1362,31,2220,3715,15285
2011,Bahamas,BHS,-,-,0,7,5,14,0,0,26,0,0,6,13,0,0,19,219
2011,Bhutan,BTN,-,-,2252,3191,3440,15413,1839,1153,27288,2320,3391,3683,15942,2283,1202,28821,58994
2011,Burkina Faso,BFA,-,-,0,11,5,81,0,49,146,0,12,6,278,0,58,354,1599
2011,Belarus,BLR,-,-,9,55,76,800,158,230,1328,10,55,111,791,114,293,1374,6826
2011,Bolivia (Plurinational State of),BOL,-,-,15,5,18,64,5,19,126,0,6,7,120,13,25,171,767
2011,Botswana,BWA,-,-,6,14,0,137,0,0,157,5,5,7,50,0,0,67,256
2011,Brazil,BRA,-,-,5,27,16,101,15,13,177,0,16,15,83,0,0,114,1237
2011,Bosnia and Herzegovina,BIH,-,-,782,2938,3653,36368,14145,28857,86743,776,3000,3870,37277,9940,30127,84990,227555
2011,Bulgaria,BGR,-,-,20,11,19,122,17,43,232,5,23,8,119,44,61,260,2505
2011,Belize,BLZ,-,-,0,0,0,0,0,0,0,0,9,0,0,0,0,9,43
2011,Cambodia,KHM,-,-,5,25,19,132,20,7120,7321,5,25,36,166,14,7118,7364,15383
2011,Canada,CAN,-,-,5,5,0,6,5,0,21,5,5,5,7,5,0,27,108
2011,Central African Rep.,CAF,-,-,18624,31380,25016,60664,3093,280,139057,17990,31826,24048,50231,3345,362,127802,269860
2011,Chad,TCD,-,-,695,1276,875,2705,219,3328,9098,740,1231,855,4395,249,3854,11324,169741
2011,China,CHN,-,-,164,400,279,4005,217,942,6007,152,376,297,5650,218,1510,8203,201744
2011,Chile,CHL,-,-,13,0,5,150,81,70,319,0,0,14,210,83,76,383,1299
2011,Cameroon,CMR,-,-,301,317,248,1469,78,412,2825,250,278,245,1721,36,679,3209,17629
2011,Congo,COG,-,-,260,880,894,3075,120,1659,6888,285,784,1036,4423,151,1666,8345,23431
2011,Dem. Rep. of the Congo,COD,-,-,52213,67544,40627,123686,7969,6096,298135,51326,66408,40289,106172,5884,6854,276933,2253397
2011,Comoros,COM,-,-,0,0,5,5,0,122,132,0,6,0,10,0,224,240,448
2011,Colombia,COL,-,-,2397,4871,5028,25674,1203,1984537,2023710,2715,5286,5287,28211,1546,1906495,1949540,4326845
2011,Costa Rica,CRI,-,-,0,5,8,12,0,0,25,0,6,8,16,0,0,30,371
2011,Cuba,CUB,-,-,14,52,92,1139,94,59,1450,20,73,103,1870,126,93,2285,8753
2011,Cabo Verde,CPV,-,-,0,0,0,0,0,0,0,0,0,0,5,0,0,5,27
2011,Cyprus,CYP,-,-,0,0,0,5,0,0,5,0,0,0,0,0,0,0,10
2011,Czechia,CZE,-,-,46,60,61,209,40,23,439,52,73,41,237,63,27,493,1414
2011,Denmark,DNK,-,-,0,0,0,0,0,0,0,0,0,0,0,0,0,0,6
2011,Djibouti,DJI,-,-,38,35,25,125,9,90,322,33,36,17,78,5,91,260,870
2011,Dominica,DMA,-,-,0,0,0,0,0,0,0,0,0,0,6,0,0,6,60
2011,Dominican Rep.,DOM,-,-,5,12,23,191,0,0,231,0,10,21,145,0,0,176,586
2011,Ecuador,ECU,-,-,19,31,23,69,0,14,156,14,41,23,106,0,18,202,1166
2011,Equatorial Guinea,GNQ,-,-,0,6,5,20,0,14,45,0,6,0,58,5,16,85,298
2011,Eritrea,ERI,-,-,8661,12285,9698,42025,2703,10351,85723,9289,13042,11631,57041,3764,12310,107077,266539
2011,Estonia,EST,-,-,0,5,5,33,15,5,63,0,0,20,22,11,10,63,259
2011,Ethiopia,ETH,-,-,3464,4379,2940,19266,627,3435,34111,3649,4714,3575,25660,645,3296,41539,109428
2011,Fiji,FJI,-,-,0,0,0,20,0,0,20,0,0,10,38,0,0,48,1832
2011,Finland,FIN,-,-,0,0,0,5,0,0,5,0,0,0,0,0,0,0,11
2011,France,FRA,-,-,0,0,16,18,0,0,34,0,18,0,10,0,0,28,143
2011,Gabon,GAB,-,-,0,5,6,11,0,21,43,0,0,0,26,0,13,39,215
2011,Gambia,GMB,-,-,13,18,28,129,0,69,257,10,6,42,871,10,63,1002,3751
2011,Palestinian,PSE,-,-,6815,9035,5994,17463,1490,92,40889,7557,6068,11042,19814,1312,228,46021,95901
2011,United Kingdom of Great Britain and Northern Ireland,GBR,-,-,0,11,0,17,0,0,28,0,5,16,5,0,0,26,190
2011,Georgia,GEO,-,-,35,85,131,993,201,1160,2605,39,85,131,1325,119,1119,2818,287069
2011,Germany,DEU,-,-,0,0,0,11,0,10,21,0,0,6,11,0,5,22,198
2011,Ghana,GHA,-,-,1431,2005,824,4560,479,218,9517,1384,2150,1000,4393,561,351,9839,22826
2011,Guinea-Bissau,GNB,-,-,13,0,5,58,0,282,358,5,0,25,358,0,642,1030,1604
2011,Greece,GRC,-,-,0,5,5,7,0,0,17,0,5,0,26,0,0,31,92
2011,Grenada,GRD,-,-,0,0,11,38,0,0,49,0,0,0,10,0,0,10,370
2011,Guatemala,GTM,-,-,24,56,41,294,16,5,436,21,54,52,496,25,17,665,7192
2011,Guinea,GIN,-,-,110,155,185,551,22,2751,3774,109,163,191,1675,19,2420,4577,17805
2011,Guyana,GUY,-,-,0,0,11,75,0,0,86,0,0,5,59,0,0,64,870
2011,Haiti,HTI,-,-,111,271,337,2321,152,2757,5949,93,250,272,5633,43,3234,9525,41115
2011,"China, Hong Kong SAR",HKG,-,-,0,0,0,0,0,0,0,0,0,0,0,0,0,0,19
2011,Honduras,HND,-,-,19,40,53,246,5,0,363,16,37,45,431,5,0,534,2814
2011,Croatia,HRV,-,-,40,518,1736,17618,11659,10989,42560,51,588,1786,20925,7292,10141,40783,84904
2011,Hungary,HUN,-,-,296,470,320,1858,50,43,3037,337,454,381,2032,124,120,3448,7240
2011,Cote d'Ivoire,CIV,-,-,26066,29753,20268,61818,5392,886,144183,25991,31434,21825,60309,4232,1396,145187,300621
2011,India,IND,-,-,64,78,64,917,51,138,1312,60,90,115,4003,140,177,4585,20986
2011,Indonesia,IDN,-,-,74,116,99,498,29,6,822,81,134,110,369,39,0,733,16445
2011,Ireland,IRL,-,-,0,0,0,0,0,0,0,0,0,0,5,0,0,5,12
2011,Iran (Islamic Rep. of),IRN,-,-,740,1673,1816,12801,1763,1157,19950,851,1902,2063,20454,1844,2048,29162,90816
2011,Iraq,IRQ,-,-,148680,199702,181820,690123,87528,2703,1310556,156786,208063,190636,692963,78709,3616,1330773,2792386
2011,Israel,ISR,-,-,17,38,36,213,90,0,394,27,37,49,288,56,0,457,1830
2011,Italy,ITA,-,-,5,0,0,11,0,5,21,0,5,0,20,0,0,25,89
2011,Jamaica,JAM,-,-,5,15,25,306,6,0,357,5,28,15,280,5,5,338,1827
2011,Jordan,JOR,-,-,19,54,39,268,26,22,428,19,67,68,562,98,26,840,2774
2011,Japan,JPN,-,-,17,29,10,39,0,0,95,20,33,11,16,0,0,80,212
2011,Kazakhstan,KAZ,-,-,21,55,54,654,238,225,1247,5,55,79,606,85,171,1001,4244
2011,Kenya,KEN,-,-,377,555,399,1438,113,38,2920,399,568,341,1073,117,23,2521,310321
2011,Kyrgyzstan,KGZ,-,-,7567,10256,9675,51070,5852,110,84530,8603,11389,11101,46374,4165,102,81734,168624
2011,Kiribati,KIR,-,-,0,0,0,0,0,0,0,0,0,0,0,0,0,0,36
2011,Rep. of Korea,KOR,-,-,12,19,34,98,0,0,163,12,30,25,69,5,0,141,681
2011,Dem. People's Rep. of Korea,PRK,-,-,25,26,12,241,21,13,338,29,25,19,206,7,18,304,1596
2011,Kuwait,KWT,-,-,5,22,5,76,13,0,121,5,8,18,150,13,5,199,1276
2011,Lao People's Dem. Rep.,LAO,-,-,0,13,0,70,11,3612,3706,0,14,0,106,13,3943,4076,8110
2011,Liberia,LBR,-,-,2033,5433,4410,18279,755,94,31004,1998,5601,4484,18444,774,177,31478,68736
2011,Libya,LBY,-,-,53,62,37,228,23,80,483,41,71,52,729,49,150,1092,99891
2011,Saint Lucia,LCA,-,-,28,43,47,534,0,0,652,28,49,48,278,0,0,403,1111
2011,Lebanon,LBN,-,-,126,316,490,3874,639,58,5503,132,400,557,5597,634,143,7463,16388
2011,Lesotho,LSO,-,-,0,0,0,0,0,0,0,0,0,0,0,0,0,0,163
2011,Sri Lanka,LKA,-,-,286,609,509,5219,928,41812,49363,292,608,641,15069,1016,50459,68085,285242
2011,Lithuania,LTU,-,-,14,16,17,102,35,6,190,0,16,7,119,28,24,194,634
2011,Latvia,LVA,-,-,5,26,17,179,98,29,354,0,18,29,173,67,21,308,849
2011,"China, Macao SAR",MAC,-,-,0,0,0,0,0,0,0,0,0,0,0,0,0,0,8
2011,Madagascar,MDG,-,-,5,0,0,13,0,105,123,0,0,0,10,0,118,128,298
2011,Mauritania,MRT,-,-,3347,4192,2251,6287,559,1016,17652,3565,4155,2219,5694,553,3852,20038,40498
2011,North Macedonia,MKD,-,-,126,301,353,2461,103,151,3495,145,297,353,3517,78,178,4568,9939
2011,Monaco,MCO,-,-,0,0,0,0,0,0,0,0,0,0,0,0,0,0,5
2011,Rep. of Moldova,MDA,-,-,10,47,115,1360,778,195,2505,5,46,120,1299,566,192,2228,6718
2011,Maldives,MDV,-,-,0,0,0,0,0,0,0,0,0,0,0,0,5,5,21
2011,Mexico,MEX,-,-,178,313,253,1875,24,0,2643,198,342,248,2243,8,6,3045,12799
2011,Mali,MLI,-,-,5,12,0,35,0,2268,2320,0,5,20,130,5,832,992,4678
2011,Malaysia,MYS,-,-,5,0,6,33,0,6,50,5,0,0,21,0,0,26,667
2011,Malawi,MWI,-,-,0,0,0,15,0,0,15,5,0,0,5,0,0,10,3179
2011,Mongolia,MNG,-,-,20,7,26,218,0,177,448,24,17,10,138,0,123,312,3425
2011,Morocco,MAR,-,-,18,41,31,420,34,45,589,19,39,34,1286,36,114,1528,3439
2011,Mozambique,MOZ,-,-,0,5,13,19,0,5,42,0,0,6,79,0,7,92,493
2011,Malta,MLT,-,-,0,0,0,0,0,0,0,0,0,0,0,0,0,0,5
2011,Montenegro,MNE,-,-,43,168,221,1245,70,26,1773,48,139,265,1449,47,24,1972,4004
2011,Mauritius,MUS,-,-,0,0,0,0,0,0,0,0,0,0,5,0,0,5,143
2011,Myanmar,MMR,-,-,24769,36861,37404,136058,20453,598,256143,24519,36388,36293,173001,17509,1247,288957,777916
2011,Namibia,NAM,-,-,58,86,44,643,0,0,831,63,88,50,1054,17,0,1272,2159
2011,Nepal,NPL,-,-,0,27,7,203,7,21,265,0,22,30,578,5,66,701,8849
2011,Netherlands (Kingdom of the),NLD,-,-,0,6,0,14,0,0,20,5,12,0,16,0,0,33,103
2011,Niger,NER,-,-,5,17,10,60,0,43,135,0,8,20,278,0,59,365,1095
2011,Nicaragua,NIC,-,-,12,35,40,354,31,0,472,22,41,36,472,25,0,596,1602
2011,Nigeria,NGA,-,-,410,657,543,3034,91,412,5147,406,718,520,5341,99,414,7498,27659
2011,Niue,NIU,-,-,0,0,0,0,0,0,0,0,0,0,0,0,0,0,7
2011,Norway,NOR,-,-,0,0,5,0,0,0,5,0,0,0,0,0,0,0,10
2011,Nauru,NRU,-,-,0,0,0,0,0,0,0,0,0,0,0,0,0,0,5
2011,New Zealand,NZL,-,-,0,0,5,0,0,0,5,0,0,8,0,0,0,8,19
2011,Oman,OMN,-,-,0,5,5,11,0,0,21,0,7,0,14,5,0,26,58
2011,Pakistan,PAK,-,-,4691,6891,3097,13348,1151,154,29332,5052,8836,4641,17803,1427,429,38188,502559
2011,Panama,PAN,-,-,0,5,12,16,0,0,33,0,0,5,16,0,0,21,129
2011,Paraguay,PRY,-,-,0,0,18,8,0,0,26,0,0,5,18,0,0,23,113
2011,Peru,PER,-,-,11,20,86,730,52,126,1025,16,41,85,764,55,168,1129,5986
2011,Philippines,PHL,-,-,5,8,14,259,23,0,309,0,5,21,145,14,0,185,240765
2011,Papua New Guinea,PNG,-,-,0,0,0,0,0,0,0,0,0,0,0,0,0,0,172
2011,Poland,POL,-,-,27,57,70,317,69,186,726,24,68,53,330,99,241,815,2160
2011,Portugal,PRT,-,-,5,5,0,24,0,0,34,0,5,6,27,0,5,43,96
2011,Qatar,QAT,-,-,0,8,0,27,5,0,40,5,0,0,44,0,0,49,100
2011,Romania,ROU,-,-,28,47,47,279,111,105,617,20,58,45,332,78,138,671,3887
2011,South Africa,ZAF,-,-,5,10,5,32,0,5,57,0,11,0,56,9,13,89,622
2011,Russian Federation,RUS,-,-,542,1467,1734,14157,8461,7009,33370,568,1559,1885,12799,5870,6992,29673,164307
2011,Rwanda,RWA,-,-,7383,9434,11811,19241,881,2014,50764,8059,11442,15166,20512,1040,1760,57979,116087
2011,El Salvador,SLV,-,-,38,59,84,662,49,7,899,26,76,97,885,92,13,1189,8358
2011,Saudi Arabia,SAU,-,-,0,37,14,130,19,0,200,21,25,7,200,21,0,274,836
2011,Serbia and Kosovo: S/RES/1244 (1999),SRB,-,-,2967,14740,21416,110422,26756,6064,182365,3143,15717,22449,124387,22473,6633,194802,414959
2011,Senegal,SEN,-,-,1253,1806,1014,4041,513,338,8965,1313,1877,1108,3343,471,300,8412,18636
2011,Seychelles,SYC,-,-,0,0,0,0,0,0,0,0,0,0,0,0,0,0,39
2011,Singapore,SGP,-,-,0,0,0,7,0,0,7,8,0,0,11,0,0,19,83
2011,Sierra Leone,SLE,-,-,70,90,107,466,36,176,945,56,122,145,1135,28,2139,3625,11039
2011,Solomon Islands,SLB,-,-,0,0,0,0,0,0,0,0,0,0,5,0,0,5,77
2011,Somalia,SOM,-,-,229016,250397,149161,494245,34449,864,1158132,220518,266988,160046,509087,33087,1305,1191031,2465172
2011,Spain,ESP,-,-,5,21,5,18,0,0,49,5,12,0,27,0,5,49,127
2011,Viet Nam,VNM,-,-,113,254,665,9562,860,148683,160137,111,283,659,12373,555,162867,176848,339200
2011,Saint Kitts and Nevis,KNA,-,-,0,0,0,7,0,0,7,0,7,0,7,0,0,14,21
2011,Sao Tome and Principe,STP,-,-,0,0,7,7,0,0,14,0,0,0,18,0,0,18,32
2011,Sudan,SDN,-,-,41345,58482,39820,104624,8672,1209681,1462624,43253,60836,41692,84059,6197,1211140,1447177,2953971
2011,Suriname,SUR,-,-,0,0,0,0,0,0,0,0,5,0,0,0,0,5,27
2011,South Sudan,SSD,-,-,0,0,0,0,0,0,0,0,0,0,5,0,0,5,560166
2011,Slovakia,SVK,-,-,32,34,31,164,13,68,342,35,43,36,168,7,62,351,809
2011,Slovenia,SVN,-,-,0,0,0,5,0,0,5,0,0,0,12,0,0,12,37
2011,Eswatini,SWZ,-,-,5,0,0,38,0,0,43,0,0,5,23,0,0,28,170
2011,Sweden,SWE,-,-,6,0,0,0,0,0,6,0,12,0,0,0,0,12,41
2011,Switzerland,CHE,-,-,0,0,0,0,5,0,5,0,0,0,0,0,0,0,20
2011,Syrian Arab Rep.,SYR,-,-,1359,1867,1601,6639,447,405,12318,1518,2016,1794,9897,483,682,16390,48482
2011,United Rep. of Tanzania,TZA,-,-,5,26,20,42,0,14,107,7,24,17,91,0,24,163,1707
2011,Turks and Caicos Islands,TCA,-,-,0,6,0,0,0,0,6,0,0,0,0,0,0,0,20
2011,Thailand,THA,-,-,13,16,34,139,6,0,208,13,22,23,98,6,0,162,540
2011,Tajikistan,TJK,-,-,16,19,17,65,20,12,149,20,33,43,150,7,16,269,975
2011,Turkmenistan,TKM,-,-,0,10,5,83,24,5,127,6,7,10,81,15,16,135,781
2011,Timor-Leste,TLS,-,-,0,0,0,0,0,0,0,0,0,0,0,0,0,0,8
2011,Togo,TGO,-,-,661,960,791,3526,78,556,6572,638,999,761,6078,95,868,9439,20827
2011,Tonga,TON,-,-,0,0,0,0,0,0,0,0,0,0,0,0,0,0,28
2011,Trinidad and Tobago,TTO,-,-,0,14,11,50,0,0,75,0,9,8,39,0,0,56,399
2011,Tunisia,TUN,-,-,11,21,46,203,8,193,482,20,34,58,1688,23,424,2247,3528
2011,Türkiye,TUR,-,-,1816,4301,5565,28790,3737,4513,48722,1919,4427,5869,53564,3874,10467,80120,146648
2011,United Arab Emirates,ARE,-,-,12,5,8,160,32,0,217,11,13,22,156,19,0,221,490
2011,Uganda,UGA,-,-,70,108,129,533,10,147,997,67,123,99,745,24,167,1225,37404
2011,Ukraine,UKR,-,-,39,343,774,6492,2789,436,10873,48,366,821,6625,2265,369,10494,26411
2011,Uruguay,URY,-,-,0,0,6,17,0,0,23,0,0,6,17,9,5,37,224
2011,United States of America,USA,-,-,221,415,92,92,22,0,842,236,428,83,101,12,0,860,4366
2011,Uzbekistan,UZB,-,-,46,152,165,1108,171,155,1797,48,178,200,1036,117,116,1695,14170
2011,Saint Vincent and the Grenadines,VCT,-,-,30,70,81,719,7,0,907,20,75,47,343,0,0,485,2031
2011,Venezuela (Bolivarian Republic of),VEN,-,-,21,66,46,272,7,0,412,18,44,50,294,11,7,424,8145
2011,Western Sahara,ESH,-,-,0,0,0,9,0,5,14,0,0,0,363,0,19,382,116419
2011,Yemen,YEM,-,-,11789,50066,31507,76991,4228,79,174660,12784,55173,37266,64332,4846,83,174484,350768
2011,Zambia,ZMB,-,-,0,0,7,18,0,0,25,0,0,0,18,0,0,18,416
2011,Zimbabwe,ZWE,-,-,68,106,93,555,33,11,866,81,80,68,748,16,21,1014,116036
2011,Stateless,XXA,-,-,100,179,276,1545,300,42,2442,87,221,272,2569,354,80,3583,20411
2011,Tibetan,TIB,-,-,0,0,0,0,0,7500,7500,0,0,0,0,0,7500,7500,15193
2011,Unknown ,UNK,-,-,478,842,820,4783,535,3938,11396,457,866,868,7559,587,5866,16203,428889
2012,Afghanistan,AFG,-,-,152341,361953,250850,667767,42149,2780,1477840,159501,378533,287989,740919,71701,10649,1649292,4015202
2012,Albania,ALB,-,-,35,63,107,1299,140,1005,2649,44,68,123,1944,148,1137,3464,17074
2012,Algeria,DZA,-,-,36,96,105,682,10,579,1508,44,96,171,2485,47,830,3673,8120
2012,Andorra,AND,-,-,0,0,0,0,0,0,0,0,0,0,0,0,0,0,6
2012,Angola,AGO,-,-,5205,11941,8508,22920,3621,1430,53625,5149,11824,9566,21263,3156,2067,53025,116809
2012,Antigua and Barbuda,ATG,-,-,0,0,6,19,0,0,25,0,0,5,12,0,0,17,80
2012,Egypt,EGY,-,-,61,113,86,373,97,116,846,70,110,149,1092,131,270,1822,14132
2012,Argentina,ARG,-,-,0,0,12,18,5,0,35,0,11,0,22,5,5,43,476
2012,Armenia,ARM,-,-,57,184,307,1988,275,2013,4824,97,223,322,2112,176,2035,4965,18825
2012,Australia,AUS,-,-,0,7,0,10,9,0,26,0,7,0,8,0,0,15,52
2012,Austria,AUT,-,-,0,0,0,5,0,0,5,0,5,0,0,0,5,10,20
2012,Azerbaijan,AZE,-,-,134,307,369,3190,953,1518,6471,151,362,388,3316,618,1413,6248,618064
2012,Bahrain,BHR,-,-,5,5,5,23,0,0,38,0,0,6,20,5,0,31,397
2012,Barbados,BRB,-,-,0,0,5,29,0,0,34,5,0,0,38,0,0,43,106
2012,Burundi,BDI,-,-,20767,35073,26578,68066,5525,394,156403,20450,34559,26375,70724,7066,459,159633,327814
2012,Belgium,BEL,-,-,0,0,6,0,0,0,6,0,7,0,7,0,0,14,104
2012,Benin,BEN,-,-,0,18,13,79,0,19,129,5,21,20,284,0,21,351,879
2012,Bermuda,BMU,-,-,0,0,0,0,0,0,0,5,0,0,0,0,0,5,5
2012,Bangladesh,BGD,-,-,18,31,41,233,14,372,709,26,30,98,1549,36,2789,4528,18321
2012,Bahamas,BHS,-,-,0,8,0,5,0,0,13,0,6,9,13,0,0,28,227
2012,Bhutan,BTN,-,-,1808,2547,2483,11508,1462,11,19819,1862,2717,2709,12149,1854,73,21364,41681
2012,Burkina Faso,BFA,-,-,5,5,5,78,0,71,164,5,11,17,287,5,68,393,1962
2012,Belarus,BLR,-,-,22,43,81,823,165,355,1489,10,46,123,817,126,544,1666,7194
2012,Bolivia (Plurinational State of),BOL,-,-,10,5,19,81,5,20,140,0,6,7,101,13,25,152,778
2012,Botswana,BWA,-,-,0,11,10,112,0,0,133,5,5,7,42,0,0,59,251
2012,Brazil,BRA,-,-,0,21,19,84,13,14,151,0,13,29,67,0,0,109,1315
2012,Bosnia and Herzegovina,BIH,-,-,181,621,1287,15611,5746,79588,103034,227,677,1413,15485,3732,82920,104454,212847
2012,Bulgaria,BGR,-,-,10,16,15,105,16,52,214,5,17,11,97,35,71,236,2279
2012,Belize,BLZ,-,-,0,0,0,0,0,0,0,0,0,6,0,0,0,6,40
2012,Cambodia,KHM,-,-,5,23,24,131,15,6510,6708,6,19,24,174,10,6570,6803,14230
2012,Canada,CAN,-,-,5,8,0,8,5,0,26,0,8,8,5,6,0,27,126
2012,Central African Rep.,CAF,-,-,10468,20036,14750,35319,1992,287,82852,10533,20011,14493,25822,2391,367,73617,218145
2012,Chad,TCD,-,-,504,791,589,1937,127,3458,7406,498,750,566,3344,200,4004,9362,133432
2012,China,CHN,-,-,151,326,246,3506,150,1656,6035,141,309,258,4643,164,2537,8052,208811
2012,Chile,CHL,-,-,0,5,0,114,74,70,263,0,0,14,184,83,75,356,1208
2012,Cameroon,CMR,-,-,110,249,139,1178,49,446,2171,112,218,163,1838,25,852,3208,16740
2012,Congo,COG,-,-,92,240,217,924,13,1712,3198,108,208,209,1357,65,1748,3695,14922
2012,Dem. Rep. of the Congo,COD,-,-,41049,60412,45509,97333,6482,6534,257319,41014,59570,46092,89230,4645,7366,247917,3237014
2012,Comoros,COM,-,-,0,0,5,10,0,135,150,0,6,0,5,0,273,284,503
2012,Colombia,COL,-,-,917,3011,3212,18569,874,2014563,2041146,1011,3263,3595,21520,1255,1933278,1963922,4356256
2012,Costa Rica,CRI,-,-,0,6,0,5,5,0,16,0,5,7,8,0,0,20,348
2012,Cuba,CUB,-,-,14,55,82,970,78,83,1282,25,70,110,1686,114,183,2188,8545
2012,Cabo Verde,CPV,-,-,0,0,0,5,0,0,5,0,0,0,5,0,0,5,32
2012,Cyprus,CYP,-,-,0,0,0,5,0,0,5,0,0,0,0,0,0,0,10
2012,Czechia,CZE,-,-,16,32,12,80,36,20,196,16,24,17,87,63,26,233,814
2012,Denmark,DNK,-,-,0,0,0,0,0,0,0,0,0,0,0,0,0,0,6
2012,Djibouti,DJI,-,-,28,31,16,104,12,107,298,27,33,17,78,0,104,259,925
2012,Dominica,DMA,-,-,0,0,0,7,0,0,7,0,0,0,0,0,0,0,64
2012,Dominican Rep.,DOM,-,-,6,0,31,233,0,8,278,0,8,15,124,0,0,147,635
2012,Ecuador,ECU,-,-,20,44,12,68,5,14,163,5,36,20,85,5,18,169,1367
2012,Equatorial Guinea,GNQ,-,-,5,0,5,30,0,15,55,0,0,5,48,5,16,74,308
2012,Eritrea,ERI,-,-,7284,13058,11584,46673,3731,15918,98248,7779,13946,14136,62273,4812,18335,121281,305964
2012,Estonia,EST,-,-,0,8,5,23,19,5,60,0,9,10,17,9,10,55,483
2012,Ethiopia,ETH,-,-,4673,5896,4772,21631,727,3461,41160,4884,6199,5825,25458,899,3588,46853,121626
2012,Fiji,FJI,-,-,0,0,0,10,0,0,10,0,0,0,19,0,0,19,1583
2012,Finland,FIN,-,-,0,0,6,0,0,0,6,0,0,0,0,0,0,0,11
2012,France,FRA,-,-,0,7,0,16,0,0,23,0,0,12,5,0,0,17,132
2012,Gabon,GAB,-,-,0,8,10,10,0,16,44,0,0,0,32,0,21,53,245
2012,Gambia,GMB,-,-,21,22,15,143,0,80,281,10,11,53,1067,15,104,1260,4816
2012,Palestinian,PSE,-,-,6835,9189,6330,17141,1444,137,41076,7544,6238,11450,19526,1268,457,46483,97339
2012,United Kingdom of Great Britain and Northern Ireland,GBR,-,-,0,0,7,7,0,0,14,0,0,0,7,0,0,7,195
2012,Georgia,GEO,-,-,53,121,133,1125,237,1330,2999,79,112,138,1888,156,1355,3728,293619
2012,Germany,DEU,-,-,0,0,0,5,0,10,15,0,0,5,5,0,5,15,195
2012,Ghana,GHA,-,-,2011,2538,1059,5843,609,225,12285,1954,2661,1189,4341,559,376,11080,27738
2012,Guinea-Bissau,GNB,-,-,11,0,6,92,0,301,410,12,0,45,558,0,653,1268,2071
2012,Greece,GRC,-,-,0,9,8,32,0,5,54,0,0,8,55,0,0,63,175
2012,Grenada,GRD,-,-,0,0,0,28,0,0,28,0,0,0,5,0,0,5,365
2012,Guatemala,GTM,-,-,30,27,46,218,0,5,326,15,35,40,371,0,17,478,7714
2012,Guinea,GIN,-,-,80,91,97,511,10,3278,4067,51,79,155,1646,14,2982,4927,23566
2012,Guyana,GUY,-,-,5,0,0,30,0,0,35,0,5,0,33,0,5,43,873
2012,Haiti,HTI,-,-,115,208,236,1776,116,1632,4083,113,166,309,5741,96,2083,8508,46767
2012,"China, Hong Kong SAR",HKG,-,-,0,0,0,51,0,0,51,0,0,5,0,0,0,5,82
2012,Honduras,HND,-,-,29,49,60,224,0,0,362,24,46,62,395,0,0,527,3416
2012,Croatia,HRV,-,-,99,564,1757,17954,11699,10443,42516,100,614,1786,21315,7317,9641,40773,84514
2012,Hungary,HUN,-,-,191,290,235,1271,44,39,2070,207,298,264,1391,107,109,2376,4816
2012,Cote d'Ivoire,CIV,-,-,11363,14172,8363,33727,2409,1010,71044,11441,14391,9265,31887,2056,1492,70532,157233
2012,India,IND,-,-,69,89,42,850,44,221,1315,81,81,104,3952,162,228,4608,21345
2012,Indonesia,IDN,-,-,306,427,349,1491,91,7,2671,315,476,396,1220,113,0,2520,16012
2012,Ireland,IRL,-,-,0,0,0,5,0,0,5,5,0,0,0,0,0,5,17
2012,Iran (Islamic Rep. of),IRN,-,-,798,1792,2093,13941,1863,1705,22192,849,2020,2681,22188,1940,3201,32879,99975
2012,Iraq,IRQ,-,-,101150,218482,182488,315184,55772,2862,875938,115687,149113,144199,441290,44620,4521,899430,1902253
2012,Israel,ISR,-,-,21,32,24,183,74,5,339,29,32,28,210,50,10,359,1742
2012,Italy,ITA,-,-,6,6,0,25,0,7,44,9,0,0,14,0,0,23,119
2012,Jamaica,JAM,-,-,6,12,6,207,0,0,231,0,30,24,207,5,6,272,1901
2012,Jordan,JOR,-,-,20,63,39,296,18,30,466,17,85,55,509,111,59,836,2985
2012,Japan,JPN,-,-,12,28,11,29,5,0,85,24,29,10,15,0,0,78,210
2012,Kazakhstan,KAZ,-,-,10,72,59,662,267,355,1425,15,56,73,607,97,306,1154,4493
2012,Kenya,KEN,-,-,398,553,390,1333,118,58,2850,397,533,358,994,124,52,2458,422490
2012,Kyrgyzstan,KGZ,-,-,7792,10364,9943,52535,6021,238,86893,8875,11620,11321,47848,4266,257,84187,173286
2012,Kiribati,KIR,-,-,0,0,0,0,0,0,0,0,0,0,0,0,0,0,44
2012,Rep. of Korea,KOR,-,-,8,13,33,98,6,0,158,19,24,31,50,6,0,130,738
2012,Dem. People's Rep. of Korea,PRK,-,-,50,59,31,388,74,27,629,60,43,46,304,34,44,531,2149
2012,Kuwait,KWT,-,-,5,19,17,92,17,0,150,6,9,31,166,14,10,236,1324
2012,Lao People's Dem. Rep.,LAO,-,-,0,0,5,52,14,3588,3659,0,0,0,96,12,3917,4025,7991
2012,Liberia,LBR,-,-,495,1434,1380,5804,221,96,9430,521,1392,1457,6445,270,223,10308,25449
2012,Libya,LBY,-,-,86,109,41,484,56,91,867,90,95,92,1731,114,206,2328,66552
2012,Saint Lucia,LCA,-,-,17,43,45,391,0,0,496,23,39,37,217,0,0,316,1084
2012,Lebanon,LBN,-,-,109,338,478,3944,698,67,5634,119,374,562,5625,687,189,7556,17076
2012,Lesotho,LSO,-,-,0,0,0,0,0,0,0,0,0,0,0,0,0,0,284
2012,Sri Lanka,LKA,-,-,272,488,556,4729,926,41750,48721,277,546,997,13592,1060,50356,66828,240220
2012,Lithuania,LTU,-,-,8,6,15,96,45,10,180,7,9,9,98,33,21,177,577
2012,Latvia,LVA,-,-,0,11,22,141,98,28,300,6,24,17,148,69,21,285,756
2012,Madagascar,MDG,-,-,0,5,0,25,0,115,145,0,5,0,10,0,124,139,326
2012,Mauritania,MRT,-,-,2673,3384,1874,4886,424,1109,14350,2880,3392,1878,4643,445,3958,17196,36775
2012,North Macedonia,MKD,-,-,309,444,503,3253,134,177,4820,356,570,524,4215,140,196,6001,12269
2012,Monaco,MCO,-,-,0,0,0,0,0,0,0,0,0,0,0,0,0,0,5
2012,Rep. of Moldova,MDA,-,-,6,37,93,1254,810,202,2402,0,42,112,1189,578,203,2124,6578
2012,Maldives,MDV,-,-,0,0,0,14,0,0,14,0,5,0,12,0,0,17,53
2012,Mexico,MEX,-,-,60,111,85,667,5,8,936,74,114,89,808,5,5,1095,12043
2012,Mali,MLI,-,-,14092,18472,9042,31587,2577,2552,78322,14073,18550,8651,24380,2649,917,69220,379709
2012,Malaysia,MYS,-,-,5,0,5,29,0,7,46,0,5,0,24,0,0,29,693
2012,Malawi,MWI,-,-,0,0,0,15,0,0,15,0,0,0,0,0,0,0,4816
2012,Mongolia,MNG,-,-,14,5,28,190,5,199,441,15,27,13,116,0,133,304,3052
2012,Morocco,MAR,-,-,21,34,31,464,48,78,676,25,33,49,1733,47,217,2104,4153
2012,Mozambique,MOZ,-,-,5,0,13,18,0,5,41,0,0,11,82,0,7,100,1020
2012,Malta,MLT,-,-,0,0,0,0,0,0,0,0,0,0,0,0,0,0,5
2012,Montenegro,MNE,-,-,55,184,233,1369,74,36,1951,64,149,288,1612,58,30,2201,4428
2012,Mauritius,MUS,-,-,0,0,0,6,0,0,6,0,0,0,0,0,5,5,171
2012,Myanmar,MMR,-,-,31380,44315,53145,153915,21760,724,305239,30342,42922,49836,189729,18672,1416,332917,871385
2012,Namibia,NAM,-,-,52,84,39,399,0,0,574,57,79,49,826,21,0,1032,1668
2012,Nepal,NPL,-,-,0,11,11,161,0,28,211,5,16,22,484,6,103,636,10112
2012,Netherlands (Kingdom of the),NLD,-,-,0,6,0,8,0,0,14,5,12,0,5,0,0,22,97
2012,Niger,NER,-,-,11,12,6,51,0,47,127,0,8,15,257,0,68,348,1178
2012,Nicaragua,NIC,-,-,17,27,37,338,31,0,450,25,36,46,453,25,0,585,1647
2012,Nigeria,NGA,-,-,463,635,484,2862,64,623,5131,423,683,474,5190,105,690,7565,32176
2012,Niue,NIU,-,-,0,0,0,0,0,0,0,0,0,0,0,0,0,0,10
2012,Norway,NOR,-,-,0,0,5,0,0,0,5,0,0,0,0,0,0,0,10
2012,New Zealand,NZL,-,-,0,0,6,0,0,0,6,0,0,8,0,0,0,8,25
2012,Oman,OMN,-,-,0,0,0,18,0,0,18,0,9,0,18,0,0,27,62
2012,Pakistan,PAK,-,-,60781,77407,39201,168810,8539,214,354952,75634,100168,62352,167328,15522,790,421794,831478
2012,Panama,PAN,-,-,0,5,6,19,0,0,30,0,0,9,10,0,0,19,138
2012,Paraguay,PRY,-,-,0,0,8,11,0,0,19,0,0,0,19,0,5,24,124
2012,Peru,PER,-,-,10,17,77,603,45,134,886,6,39,80,673,57,170,1025,5543
2012,Philippines,PHL,-,-,10,8,15,263,22,5,323,0,10,16,83,20,0,129,82515
2012,Papua New Guinea,PNG,-,-,0,0,0,0,0,0,0,0,0,0,0,0,0,0,255
2012,Poland,POL,-,-,27,52,56,298,76,178,687,22,57,53,287,107,229,755,1964
2012,Portugal,PRT,-,-,0,5,0,12,0,5,22,0,7,0,20,0,0,27,81
2012,Qatar,QAT,-,-,0,8,5,35,6,0,54,0,14,0,45,6,0,65,128
2012,Romania,ROU,-,-,49,51,48,283,105,152,688,38,80,53,334,82,211,798,3412
2012,South Africa,ZAF,-,-,8,15,6,22,0,5,56,0,7,5,68,10,18,108,634
2012,Russian Federation,RUS,-,-,705,1497,1792,14550,8828,7919,35291,750,1683,1923,13197,6120,7891,31564,136398
2012,Rwanda,RWA,-,-,6186,12803,8829,19938,845,2056,50657,6791,11142,8644,20124,741,1803,49245,107729
2012,El Salvador,SLV,-,-,43,71,79,561,51,14,819,38,76,89,814,72,20,1109,9819
2012,Saudi Arabia,SAU,-,-,0,23,23,126,22,5,199,14,24,25,204,23,0,290,952
2012,Serbia and Kosovo: S/RES/1244 (1999),SRB,-,-,3082,14521,21597,112678,27054,5941,184873,3159,15471,22485,126161,22912,6733,196921,405944
2012,Senegal,SEN,-,-,1222,1948,1167,4219,558,396,9510,1258,1933,1184,4375,527,383,9660,21365
2012,Seychelles,SYC,-,-,5,0,0,0,0,0,5,0,0,0,0,0,0,0,30
2012,Singapore,SGP,-,-,0,0,9,5,0,0,14,0,5,5,0,0,0,10,89
2012,Sierra Leone,SLE,-,-,51,100,103,517,27,189,987,42,118,152,1189,29,338,1868,10103
2012,Solomon Islands,SLB,-,-,0,0,0,0,0,0,0,0,0,0,0,0,0,0,65
2012,Somalia,SOM,-,-,206218,235177,142328,457672,30877,1625,1073897,200372,249150,148323,480026,29737,2969,1110577,2303390
2012,Spain,ESP,-,-,5,20,0,17,0,0,42,9,11,0,29,0,10,59,136
2012,Viet Nam,VNM,-,-,115,237,418,9405,933,148576,159684,111,265,492,12328,595,162827,176618,338398
2012,Saint Kitts and Nevis,KNA,-,-,0,0,0,9,0,0,9,0,0,0,11,0,0,11,30
2012,Sao Tome and Principe,STP,-,-,0,0,6,8,0,0,14,0,0,0,12,5,0,17,31
2012,Sudan,SDN,-,-,48049,62439,44177,123291,10205,936584,1224745,49389,62076,44564,90757,8489,939505,1194780,2463755
2012,Suriname,SUR,-,-,0,0,0,5,0,0,5,0,0,0,0,0,0,0,32
2012,South Sudan,SSD,-,-,7773,10744,7117,17297,968,0,43899,8101,12185,9630,11384,301,0,41601,451353
2012,Slovakia,SVK,-,-,40,39,39,155,7,63,343,43,49,34,166,9,63,364,855
2012,Slovenia,SVN,-,-,0,0,0,11,0,0,11,0,0,0,13,0,0,13,44
2012,Eswatini,SWZ,-,-,10,0,0,52,0,0,62,6,0,0,32,0,0,38,225
2012,Sweden,SWE,-,-,0,0,0,7,0,0,7,0,13,0,0,0,0,13,62
2012,Switzerland,CHE,-,-,0,5,0,5,0,0,10,0,0,0,0,0,0,0,21
2012,Syrian Arab Rep.,SYR,-,-,41674,44717,31148,104933,6733,73063,302268,40646,46108,35402,120745,5287,80979,329167,2778427
2012,United Rep. of Tanzania,TZA,-,-,23,19,5,53,5,17,122,5,0,11,103,0,31,150,1916
2012,Turks and Caicos Islands,TCA,-,-,0,9,0,0,0,0,9,0,0,0,0,0,0,0,23
2012,Thailand,THA,-,-,5,23,31,123,8,5,195,5,22,25,90,8,0,150,550
2012,Tajikistan,TJK,-,-,11,12,21,76,21,23,164,16,49,26,144,6,39,280,1114
2012,Turkmenistan,TKM,-,-,0,15,7,102,27,15,166,6,8,11,93,15,26,159,833
2012,Timor-Leste,TLS,-,-,0,0,0,0,0,0,0,0,0,0,0,0,0,0,14
2012,Togo,TGO,-,-,439,861,667,3299,59,571,5896,464,840,669,5202,90,916,8181,18701
2012,Tonga,TON,-,-,0,0,0,0,0,0,0,0,0,0,0,0,0,0,50
2012,Trinidad and Tobago,TTO,-,-,0,10,0,17,0,0,27,0,7,0,27,0,0,34,425
2012,Tunisia,TUN,-,-,16,24,37,226,10,174,487,22,17,54,1387,26,406,1912,4197
2012,Türkiye,TUR,-,-,1632,4088,5265,28675,3918,4524,48102,1693,4176,5503,52621,4288,10562,78843,144210
2012,Tuvalu,TUV,-,-,0,0,0,0,0,0,0,0,0,0,0,0,0,0,5
2012,United Arab Emirates,ARE,-,-,13,13,7,187,37,0,257,9,19,15,200,22,0,265,593
2012,Uganda,UGA,-,-,86,115,143,556,26,167,1093,97,127,105,691,36,213,1269,8664
2012,Ukraine,UKR,-,-,51,286,694,6547,2933,489,11000,46,322,707,6705,2413,445,10638,26457
2012,Uruguay,URY,-,-,0,0,5,6,0,0,11,0,0,5,12,9,0,26,201
2012,United States of America,USA,-,-,87,130,56,71,22,0,366,106,119,51,72,15,0,363,4871
2012,Uzbekistan,UZB,-,-,37,107,130,1025,183,351,1833,37,97,170,978,120,452,1854,13022
2012,Saint Vincent and the Grenadines,VCT,-,-,17,48,44,389,5,0,503,17,32,20,222,0,0,291,1801
2012,Venezuela (Bolivarian Republic of),VEN,-,-,13,41,45,187,0,0,286,7,22,43,249,10,7,338,8700
2012,Samoa,WSM,-,-,0,0,0,0,0,0,0,0,0,0,5,0,0,5,11
2012,Western Sahara,ESH,-,-,0,0,0,14,0,7,21,0,0,0,343,0,50,393,116579
2012,Yemen,YEM,-,-,16071,50093,33038,86189,5632,123,191146,15992,54619,39934,79417,6433,171,196566,389483
2012,Zambia,ZMB,-,-,0,0,0,8,0,0,8,0,0,6,14,0,0,20,484
2012,Zimbabwe,ZWE,-,-,65,91,77,376,16,18,643,82,75,56,585,9,35,842,121753
2012,Stateless,XXA,-,-,111,225,311,1594,308,193,2742,119,289,298,2625,380,489,4200,22880
2012,Tibetan,TIB,-,-,0,0,0,0,0,7500,7500,0,0,0,0,0,7500,7500,15000
2012,Unknown ,UNK,-,-,465,863,842,4966,601,13094,20831,509,851,904,10708,657,21299,34928,359843
2013,Afghanistan,AFG,-,-,125285,295728,215949,588692,35414,2046,1263114,130422,305667,242801,628335,63412,5505,1376142,3538870
2013,Albania,ALB,-,-,87,102,114,1072,105,1070,2550,105,128,147,1350,108,1245,3083,20888
2013,Algeria,DZA,-,-,34,42,42,363,0,599,1080,34,43,95,1909,16,877,2974,7939
2013,Andorra,AND,-,-,0,0,0,0,0,0,0,0,0,0,0,0,0,0,5
2013,Angola,AGO,-,-,5312,10486,7029,24475,3762,1433,52497,5637,10886,7673,21216,3382,2017,50811,108502
2013,Antigua and Barbuda,ATG,-,-,0,5,7,13,0,0,25,0,0,5,10,0,0,15,78
2013,Egypt,EGY,-,-,152,221,132,718,108,151,1482,181,215,265,1944,70,376,3051,22282
2013,Argentina,ARG,-,-,0,0,6,11,0,0,17,0,13,0,16,5,5,39,452
2013,Armenia,ARM,-,-,91,130,122,1073,173,2045,3634,122,194,149,1206,121,2004,3796,17369
2013,Australia,AUS,-,-,0,5,0,5,0,0,10,0,5,6,0,0,0,11,32
2013,Austria,AUT,-,-,0,0,0,5,0,0,5,0,0,0,0,0,0,0,15
2013,Azerbaijan,AZE,-,-,145,187,137,1878,479,1485,4311,149,236,167,1985,304,1345,4186,623450
2013,Bahrain,BHR,-,-,8,10,0,14,0,0,32,0,0,6,16,0,0,22,370
2013,Barbados,BRB,-,-,0,0,5,14,0,0,19,0,0,0,34,0,0,34,114
2013,Burundi,BDI,-,-,21636,36266,27626,65946,5624,362,157460,20995,35795,26861,68839,6995,429,159914,328236
2013,Belgium,BEL,-,-,0,5,13,0,0,0,18,0,0,0,0,0,0,0,107
2013,Benin,BEN,-,-,8,14,14,34,0,23,93,5,10,11,239,0,23,288,795
2013,Bangladesh,BGD,-,-,20,30,10,204,10,409,683,31,34,83,3168,12,3047,6375,32582
2013,Bahamas,BHS,-,-,0,0,6,5,0,0,11,0,5,0,13,0,0,18,235
2013,Bhutan,BTN,-,-,1487,1897,1701,8750,1126,15,14976,1474,1999,1900,9308,1431,87,16199,31713
2013,Burkina Faso,BFA,-,-,10,0,0,50,0,72,132,0,5,19,329,0,74,427,2515
2013,Belarus,BLR,-,-,5,15,10,129,6,252,417,10,12,37,215,15,329,618,5257
2013,Bolivia (Plurinational State of),BOL,-,-,5,8,20,49,0,20,102,0,6,7,99,15,20,147,795
2013,Botswana,BWA,-,-,0,0,13,49,0,0,62,0,12,0,18,0,0,30,266
2013,Brazil,BRA,-,-,5,15,5,28,0,8,61,15,19,15,34,0,5,88,1533
2013,Bosnia and Herzegovina,BIH,-,-,260,490,656,6808,3874,70278,82366,281,533,799,7243,2461,73185,84502,170661
2013,Bulgaria,BGR,-,-,0,10,18,59,16,40,143,0,10,0,97,43,54,204,2052
2013,Belize,BLZ,-,-,0,0,0,0,0,0,0,0,0,0,0,0,0,0,90
2013,Cambodia,KHM,-,-,5,14,12,109,10,6459,6609,0,14,11,128,10,6489,6652,13969
2013,Canada,CAN,-,-,0,9,5,5,0,0,19,0,5,11,5,0,0,21,123
2013,Central African Rep.,CAF,-,-,21001,30921,21501,52650,3518,305,129896,20903,30589,22126,40512,3408,372,117910,1154734
2013,Cayman Islands,CYM,-,-,0,0,0,0,0,0,0,0,0,0,0,0,0,0,6
2013,Chad,TCD,-,-,327,612,449,1490,78,3674,6630,352,536,506,2870,159,4219,8642,72253
2013,China,CHN,-,-,181,280,233,3184,100,1331,5309,182,257,215,4211,114,2186,7165,219920
2013,Chile,CHL,-,-,0,5,0,60,59,54,178,0,0,5,80,73,51,209,654
2013,Cameroon,CMR,-,-,76,153,105,908,35,422,1699,77,108,132,1627,14,797,2755,15625
2013,Congo,COG,-,-,87,161,169,723,10,1743,2893,83,158,166,1156,46,1748,3357,15017
2013,Dem. Rep. of the Congo,COD,-,-,458929,438378,212733,731990,42917,6906,1891853,441012,430421,185886,462494,30311,7824,1557948,3528790
2013,Comoros,COM,-,-,0,0,5,7,0,152,164,0,0,0,26,0,322,348,827
2013,Colombia,COL,-,-,692,2630,2997,16334,821,2741711,2765185,758,2845,3320,18763,1143,2631402,2658231,5780487
2013,Costa Rica,CRI,-,-,0,5,0,5,0,0,10,5,0,5,8,0,0,18,923
2013,Cuba,CUB,-,-,19,57,245,887,77,57,1342,25,81,106,1706,130,110,2158,8573
2013,Cabo Verde,CPV,-,-,0,0,0,0,0,0,0,0,0,0,7,0,0,7,39
2013,Cyprus,CYP,-,-,0,0,0,5,0,0,5,0,0,0,0,0,0,0,10
2013,Czechia,CZE,-,-,5,11,21,152,89,20,298,6,8,30,226,183,17,470,1095
2013,Denmark,DNK,-,-,0,0,0,0,0,0,0,0,0,0,0,0,0,0,11
2013,Djibouti,DJI,-,-,12,12,18,83,5,119,249,15,34,16,79,0,111,255,1138
2013,Dominica,DMA,-,-,0,0,0,5,0,0,5,0,0,0,0,0,0,0,61
2013,Dominican Rep.,DOM,-,-,5,5,29,158,0,17,214,0,18,5,138,0,0,161,1138
2013,Ecuador,ECU,-,-,12,38,13,37,0,13,113,0,30,14,68,0,18,130,3051
2013,Equatorial Guinea,GNQ,-,-,0,0,5,15,0,16,36,0,0,0,34,17,17,68,256
2013,Eritrea,ERI,-,-,7450,14875,10997,54497,4163,13805,105787,7931,15754,12841,78891,5160,16058,136635,337203
2013,Estonia,EST,-,-,0,0,0,0,0,8,8,0,0,0,7,0,0,7,371
2013,Ethiopia,ETH,-,-,4699,6475,3961,22361,729,4741,42966,5025,6856,4648,26208,925,4655,48317,129665
2013,Fiji,FJI,-,-,0,0,5,0,0,0,5,0,0,7,15,0,0,22,1572
2013,Finland,FIN,-,-,0,0,0,0,0,0,0,5,0,0,0,0,0,5,10
2013,France,FRA,-,-,0,5,0,6,0,0,11,0,5,5,15,0,0,25,134
2013,Gabon,GAB,-,-,0,0,5,5,0,19,29,0,0,0,33,0,23,56,284
2013,Gambia,GMB,-,-,38,35,18,158,0,88,337,27,30,78,1163,5,78,1381,7199
2013,Palestinian,PSE,-,-,7343,9537,6234,18894,1596,133,43737,8192,6634,11317,21158,1453,415,49169,102731
2013,United Kingdom of Great Britain and Northern Ireland,GBR,-,-,0,0,0,10,0,0,10,0,5,0,8,0,0,13,206
2013,Georgia,GEO,-,-,10613,10649,11636,75101,26672,1356,136027,11255,11612,12644,63804,16985,1334,117634,275956
2013,Germany,DEU,-,-,5,0,0,5,0,9,19,0,5,5,0,0,0,10,237
2013,Ghana,GHA,-,-,2125,2645,1047,4325,522,217,10881,2075,2862,1148,2736,242,351,9414,26025
2013,Guinea-Bissau,GNB,-,-,11,6,6,93,0,301,417,5,5,56,610,5,653,1334,2415
2013,Greece,GRC,-,-,0,8,10,23,9,0,50,0,5,5,56,14,0,80,188
2013,Grenada,GRD,-,-,0,0,0,20,0,0,20,0,0,6,6,0,0,12,371
2013,Guatemala,GTM,-,-,15,27,38,184,0,5,269,5,19,42,306,0,18,390,15055
2013,Guinea,GIN,-,-,114,91,114,515,10,3606,4450,60,64,423,2280,15,3062,5904,26163
2013,Guyana,GUY,-,-,5,0,0,22,0,0,27,0,5,0,20,0,5,30,936
2013,Haiti,HTI,-,-,102,211,230,3022,70,1621,5256,127,200,240,11052,65,2120,13804,56118
2013,"China, Hong Kong SAR",HKG,-,-,0,0,0,34,0,0,34,0,0,9,0,0,0,9,76
2013,Honduras,HND,-,-,30,56,42,233,0,0,361,32,48,56,409,5,0,550,8591
2013,Croatia,HRV,-,-,58,456,1506,14674,10216,8402,35312,71,482,1391,16137,5753,7754,31588,67626
2013,Hungary,HUN,-,-,104,180,127,742,67,35,1255,124,170,152,817,186,60,1509,3179
2013,Iceland,ISL,-,-,0,0,0,0,0,0,0,0,0,0,0,0,0,0,5
2013,Cote d'Ivoire,CIV,-,-,6249,8624,4346,19861,1478,1103,41661,5993,8538,5014,18064,877,1540,40026,120635
2013,India,IND,-,-,84,86,45,695,13,210,1133,92,109,112,2421,22,196,2952,23914
2013,Indonesia,IDN,-,-,313,420,344,1774,85,6,2942,326,479,392,1201,107,0,2505,15892
2013,Ireland,IRL,-,-,0,7,0,0,0,0,7,0,8,0,0,0,0,8,39
2013,Iran (Islamic Rep. of),IRN,-,-,863,1864,1798,14051,1211,1387,21174,905,2154,2169,22443,1595,2503,31769,103869
2013,Iraq,IRQ,-,-,71392,132419,129555,191250,33678,2604,560898,83266,97318,94941,276836,22311,3847,578519,1398751
2013,Israel,ISR,-,-,22,23,12,52,5,0,114,11,13,6,100,5,0,135,1315
2013,Italy,ITA,-,-,7,7,0,24,0,7,45,7,8,0,10,0,0,25,141
2013,Jamaica,JAM,-,-,10,11,16,159,0,0,196,0,16,17,167,0,8,208,2131
2013,Jordan,JOR,-,-,24,41,28,251,0,26,370,15,53,41,193,6,44,352,2623
2013,Japan,JPN,-,-,11,21,8,19,0,0,59,29,26,7,11,0,0,73,202
2013,Kazakhstan,KAZ,-,-,18,35,18,154,36,273,534,15,46,20,126,0,208,415,3261
2013,Kenya,KEN,-,-,404,536,385,1298,119,54,2796,420,542,344,1015,121,60,2502,10772
2013,Kyrgyzstan,KGZ,-,-,23,75,16,165,5,152,436,31,64,27,146,0,310,578,3588
2013,Kiribati,KIR,-,-,0,0,0,0,0,0,0,0,0,0,0,0,0,0,21
2013,Rep. of Korea,KOR,-,-,13,18,16,44,0,0,91,9,26,20,33,0,0,88,707
2013,Dem. People's Rep. of Korea,PRK,-,-,48,43,22,327,63,26,529,47,35,40,268,33,29,452,2103
2013,Kuwait,KWT,-,-,0,17,10,33,0,0,60,0,18,7,46,0,11,82,1144
2013,Lao People's Dem. Rep.,LAO,-,-,0,0,5,7,0,3522,3534,0,0,0,38,5,3895,3938,7777
2013,Liberia,LBR,-,-,392,917,1004,4432,134,91,6970,366,958,1016,4919,219,180,7658,19742
2013,Libya,LBY,-,-,42,62,50,205,5,83,447,62,66,52,578,10,161,929,58950
2013,Saint Lucia,LCA,-,-,0,31,24,190,0,0,245,12,17,22,115,0,0,166,968
2013,Lebanon,LBN,-,-,51,89,85,442,48,63,778,85,96,116,1058,31,147,1533,6539
2013,Lesotho,LSO,-,-,0,0,0,0,0,0,0,0,0,0,0,0,0,0,686
2013,Sri Lanka,LKA,-,-,252,456,278,2696,468,41329,45479,256,479,414,9628,275,49796,60848,181405
2013,Lithuania,LTU,-,-,0,0,0,30,0,0,30,7,0,7,27,0,18,59,293
2013,Latvia,LVA,-,-,0,0,0,29,0,21,50,5,6,0,34,0,21,66,294
2013,"China, Macao SAR",MAC,-,-,0,0,0,0,0,0,0,0,0,0,0,0,0,0,5
2013,Madagascar,MDG,-,-,0,10,0,29,0,112,151,0,5,0,7,0,124,136,466
2013,Mauritania,MRT,-,-,2901,3390,1874,4875,424,1173,14637,3112,3390,1880,4714,443,4055,17594,38082
2013,North Macedonia,MKD,-,-,443,569,450,1724,26,159,3371,502,594,518,1676,49,180,3519,8310
2013,Monaco,MCO,-,-,0,0,0,0,0,0,0,0,0,0,0,0,0,0,5
2013,Rep. of Moldova,MDA,-,-,10,0,6,107,5,191,319,0,10,10,149,0,194,363,3087
2013,Maldives,MDV,-,-,0,5,0,9,0,0,14,0,0,0,10,0,0,10,54
2013,Mexico,MEX,-,-,19,47,39,259,0,0,364,23,51,45,327,0,10,456,21663
2013,Marshall Islands,MHL,-,-,0,0,0,0,0,0,0,0,0,0,0,0,0,0,10
2013,Mali,MLI,-,-,12947,20739,8224,32937,3470,2792,81109,13021,20405,8242,23802,2858,954,69282,414163
2013,Malaysia,MYS,-,-,0,6,0,16,0,6,28,0,0,0,10,0,0,10,744
2013,Malawi,MWI,-,-,0,5,0,7,0,0,12,0,0,0,10,0,0,10,4588
2013,Mongolia,MNG,-,-,26,0,19,158,0,209,412,34,21,21,114,0,141,331,3309
2013,Morocco,MAR,-,-,15,25,11,269,5,70,395,18,18,54,1314,5,191,1600,4169
2013,Mozambique,MOZ,-,-,0,0,11,12,0,5,28,0,0,0,6,0,7,13,1478
2013,Malta,MLT,-,-,0,0,0,0,0,0,0,0,0,0,0,0,0,0,5
2013,Montenegro,MNE,-,-,35,50,41,174,17,36,353,38,49,30,165,5,31,318,1129
2013,Mauritius,MUS,-,-,0,0,0,12,0,0,12,0,0,0,0,0,6,6,192
2013,Myanmar,MMR,-,-,9879,9274,7079,43355,2124,604,72315,10322,9834,9313,94265,2251,1550,127535,896769
2013,Namibia,NAM,-,-,40,68,50,277,0,0,435,55,66,47,701,21,0,890,1414
2013,Nepal,NPL,-,-,0,10,5,106,0,28,149,0,12,19,351,0,99,481,11881
2013,Netherlands (Kingdom of the),NLD,-,-,0,0,0,14,0,0,14,0,0,0,7,0,0,7,84
2013,Niger,NER,-,-,14,5,12,13,0,38,82,10,5,10,211,0,54,290,36259
2013,Nicaragua,NIC,-,-,12,34,38,324,31,0,439,17,42,47,442,25,0,573,2037
2013,Nigeria,NGA,-,-,803,563,372,2739,75,583,5135,733,554,312,4391,80,538,6608,52505
2013,Niue,NIU,-,-,0,0,0,0,0,0,0,0,0,0,0,0,0,0,14
2013,Norway,NOR,-,-,0,0,0,0,0,0,0,0,0,0,0,5,0,5,20
2013,New Zealand,NZL,-,-,0,0,5,0,0,0,5,0,0,0,5,0,0,5,21
2013,Oman,OMN,-,-,0,0,0,0,0,0,0,0,0,0,0,0,0,0,20
2013,Pakistan,PAK,-,-,60436,75668,37934,167582,7946,204,349770,75343,98182,60404,168547,15309,789,418574,843717
2013,Panama,PAN,-,-,0,0,12,8,0,0,20,0,0,5,10,0,0,15,126
2013,Paraguay,PRY,-,-,0,0,6,5,0,0,11,0,0,0,15,0,5,20,119
2013,Peru,PER,-,-,10,21,73,666,61,134,965,6,32,89,731,79,173,1110,5458
2013,Philippines,PHL,-,-,10,8,10,232,0,8,268,0,14,8,54,5,0,81,198993
2013,Palau,PLW,-,-,0,0,0,0,0,0,0,0,0,0,0,0,0,0,5
2013,Papua New Guinea,PNG,-,-,0,0,0,0,0,0,0,0,0,0,0,0,0,0,365
2013,Poland,POL,-,-,6,20,17,161,103,103,410,5,13,12,345,267,131,773,1702
2013,Portugal,PRT,-,-,0,5,0,7,0,5,17,0,0,0,14,0,0,14,67
2013,Qatar,QAT,-,-,0,0,0,0,0,0,0,0,0,0,0,0,0,0,15
2013,Romania,ROU,-,-,25,32,38,268,53,93,509,40,43,47,365,95,119,709,3482
2013,South Africa,ZAF,-,-,0,14,22,40,0,5,81,0,8,21,106,15,18,168,776
2013,Russian Federation,RUS,-,-,1477,1929,1204,6509,405,7755,19279,1617,2187,1426,6380,256,7665,19531,109864
2013,Rwanda,RWA,-,-,5609,11768,8407,16117,725,2006,44632,6149,10392,8263,16427,712,1771,43714,96418
2013,El Salvador,SLV,-,-,32,52,71,539,42,7,743,40,78,81,788,73,13,1073,20894
2013,Saudi Arabia,SAU,-,-,0,10,17,17,0,0,44,6,29,5,30,0,0,70,777
2013,Serbia and Kosovo: S/RES/1244 (1999),SRB,-,-,2557,11559,15058,78574,25419,6392,139559,2697,12271,16189,81235,20864,7290,140546,303039
2013,Senegal,SEN,-,-,1325,2067,1210,4339,601,468,10010,1338,2050,1328,4830,519,429,10494,24495
2013,Seychelles,SYC,-,-,0,0,0,0,0,0,0,0,0,0,0,0,0,0,24
2013,Singapore,SGP,-,-,0,0,0,7,0,0,7,0,7,0,0,0,0,7,91
2013,Sierra Leone,SLE,-,-,52,83,95,457,22,194,903,46,79,158,1047,16,317,1663,9239
2013,Solomon Islands,SLB,-,-,0,0,0,0,0,0,0,0,0,0,0,0,0,0,70
2013,Somalia,SOM,-,-,70475,115077,65474,243634,11970,2113,508743,71307,119072,70420,250188,11592,3012,525591,2291481
2013,Spain,ESP,-,-,0,14,11,13,0,0,38,0,16,0,21,0,5,42,124
2013,Viet Nam,VNM,-,-,54,93,49,830,147,148382,149555,76,68,68,1362,164,162597,164335,316176
2013,Saint Kitts and Nevis,KNA,-,-,0,0,0,8,0,0,8,0,0,0,19,0,0,19,33
2013,Sao Tome and Principe,STP,-,-,0,0,6,8,0,0,14,0,0,0,12,5,0,17,31
2013,Sudan,SDN,-,-,59886,74552,51226,131234,10783,936594,1264275,61373,73384,49440,102677,8893,939466,1235233,2550614
2013,Suriname,SUR,-,-,0,0,0,0,0,0,0,0,0,0,0,0,0,0,34
2013,South Sudan,SSD,-,-,9835,15058,10014,25100,1471,11967,73445,10129,16912,13952,18059,486,11968,71506,476240
2013,Slovakia,SVK,-,-,28,28,23,137,14,63,293,29,32,27,152,36,62,338,720
2013,Slovenia,SVN,-,-,0,0,0,10,0,0,10,0,0,0,6,6,0,12,38
2013,Eswatini,SWZ,-,-,5,0,0,24,0,0,29,5,0,5,27,0,0,37,249
2013,Sweden,SWE,-,-,0,0,0,5,0,0,5,0,5,0,0,0,0,5,28
2013,Switzerland,CHE,-,-,0,0,0,0,0,0,0,0,0,0,0,0,0,0,11
2013,Syrian Arab Rep.,SYR,-,-,166827,174175,111858,431962,29552,1287,915661,174097,183920,120231,430766,23208,2648,934870,9039542
2013,United Rep. of Tanzania,TZA,-,-,16,28,26,48,0,27,145,14,24,7,113,0,19,177,2050
2013,Turks and Caicos Islands,TCA,-,-,0,0,0,0,0,0,0,0,0,0,5,0,0,5,20
2013,Thailand,THA,-,-,0,14,28,30,0,0,72,10,17,16,41,0,0,84,393
2013,Tajikistan,TJK,-,-,19,29,16,67,10,17,158,17,46,33,159,0,16,271,1261
2013,Turkmenistan,TKM,-,-,18,12,5,78,5,5,123,20,16,5,68,0,15,124,819
2013,Timor-Leste,TLS,-,-,0,0,0,0,0,0,0,0,0,0,0,0,0,0,18
2013,Togo,TGO,-,-,424,370,306,1224,46,561,2931,413,434,329,2400,76,917,4569,11809
2013,Tonga,TON,-,-,0,0,0,0,0,0,0,0,0,0,0,0,0,0,77
2013,Trinidad and Tobago,TTO,-,-,0,5,5,14,0,0,24,0,5,0,12,0,0,17,463
2013,Tunisia,TUN,-,-,14,31,31,133,0,167,376,19,11,30,989,10,377,1436,3149
2013,Türkiye,TUR,-,-,1299,2871,2353,11654,2060,4308,24545,1323,2894,2537,17697,1689,10232,36372,77120
2013,United Arab Emirates,ARE,-,-,0,7,0,0,0,0,7,0,0,6,0,0,0,6,145
2013,Uganda,UGA,-,-,372,545,342,1154,81,152,2646,398,579,376,829,26,190,2398,61920
2013,Ukraine,UKR,-,-,30,44,35,369,33,415,926,36,63,44,395,14,350,902,6791
2013,Uruguay,URY,-,-,0,0,0,0,0,0,0,0,0,0,7,0,0,7,166
2013,United States of America,USA,-,-,95,206,80,50,5,0,436,75,212,89,66,8,0,450,5046
2013,Uzbekistan,UZB,-,-,34,112,44,238,11,209,648,57,58,59,257,5,225,661,6729
2013,Saint Vincent and the Grenadines,VCT,-,-,5,20,26,182,0,0,233,5,17,21,111,0,0,154,1758
2013,Venezuela (Bolivarian Republic of),VEN,-,-,6,55,28,158,5,8,260,7,27,25,227,5,0,291,9550
2013,Samoa,WSM,-,-,0,0,0,0,0,0,0,0,0,0,7,0,0,7,7
2013,Western Sahara,ESH,-,-,0,0,0,21,0,11,32,0,0,0,342,0,80,422,116904
2013,Yemen,YEM,-,-,12705,44177,27957,63304,3564,92,151799,12626,47600,33497,58821,4319,98,156961,310901
2013,Zambia,ZMB,-,-,0,5,0,6,0,0,11,5,0,0,15,0,0,20,524
2013,Zimbabwe,ZWE,-,-,83,109,106,479,16,15,808,98,101,86,684,14,22,1005,121777
2013,Stateless,XXA,-,-,74,139,61,436,51,97,858,82,159,85,813,83,174,1396,25836
2013,Tibetan,TIB,-,-,0,0,0,5,0,7500,7505,0,0,0,9,0,7500,7509,15084
2013,Curacao ,CUW,-,-,0,0,0,0,0,0,0,0,0,0,0,0,0,0,94
2013,Unknown ,UNK,-,-,358,506,412,2818,473,1706,6273,464,576,498,7067,816,4274,13695,278863
2014,Afghanistan,AFG,-,-,133878,277623,239386,568439,52752,2097,1274175,136103,286720,257840,626895,75065,7795,1390418,3688436
2014,Albania,ALB,-,-,462,494,332,2106,50,1302,4746,547,561,416,2662,41,1376,5603,25254
2014,Algeria,DZA,-,-,53,46,53,308,0,622,1082,49,41,75,2440,25,999,3629,8648
2014,Andorra,AND,-,-,0,0,0,0,0,0,0,0,0,0,0,0,0,0,5
2014,Angola,AGO,-,-,5638,7339,4105,14980,1517,1435,35014,5652,7449,4594,14146,1594,1967,35402,75387
2014,Antigua and Barbuda,ATG,-,-,0,5,0,14,0,0,19,0,0,0,6,0,0,6,68
2014,Egypt,EGY,-,-,182,317,167,823,73,204,1766,216,310,349,2775,67,558,4275,26757
2014,Argentina,ARG,-,-,0,5,11,5,0,5,26,0,5,0,11,8,0,24,413
2014,Armenia,ARM,-,-,161,201,163,1568,228,2085,4406,197,299,213,1698,166,2043,4616,18139
2014,Australia,AUS,-,-,0,0,5,0,0,0,5,0,0,6,0,0,0,6,27
2014,Austria,AUT,-,-,0,0,0,0,0,0,0,0,0,0,0,0,0,0,5
2014,Azerbaijan,AZE,-,-,175,232,152,2071,491,1513,4634,203,303,192,2108,307,1381,4494,637791
2014,Bahrain,BHR,-,-,10,16,0,17,0,0,43,0,7,0,42,0,0,49,449
2014,Barbados,BRB,-,-,0,0,0,12,0,0,12,0,0,0,8,0,0,8,99
2014,Burundi,BDI,-,-,20771,36298,27175,69191,5657,1385,160477,20553,35887,26730,72599,7124,2691,165584,333685
2014,Belgium,BEL,-,-,0,0,5,0,0,0,5,0,0,0,0,0,0,0,97
2014,Benin,BEN,-,-,7,6,20,52,0,11,96,5,0,10,368,0,19,402,1014
2014,Bangladesh,BGD,-,-,34,47,25,261,0,472,839,57,69,69,3906,21,4267,8389,32486
2014,Bahamas,BHS,-,-,0,0,0,5,0,0,5,0,0,0,19,0,5,24,256
2014,Bhutan,BTN,-,-,1132,1480,1258,6406,791,16,11083,1126,1589,1387,6938,1050,98,12188,23823
2014,Burkina Faso,BFA,-,-,0,10,0,41,0,56,107,0,5,18,371,0,51,445,3419
2014,Belarus,BLR,-,-,32,11,23,102,7,253,428,11,18,29,152,9,315,534,5227
2014,Bolivia (Plurinational State of),BOL,-,-,0,12,10,55,0,17,94,0,6,12,94,20,18,150,856
2014,Botswana,BWA,-,-,0,5,0,17,0,0,22,0,0,0,0,0,0,0,303
2014,Brazil,BRA,-,-,5,11,6,16,0,6,44,0,13,18,17,0,14,62,2167
2014,Bosnia and Herzegovina,BIH,-,-,448,684,617,5495,2744,70226,80214,446,718,759,5955,1699,73084,82661,165386
2014,Bulgaria,BGR,-,-,7,5,6,26,15,36,95,0,5,5,39,43,47,139,1831
2014,Belize,BLZ,-,-,0,0,0,9,0,0,9,0,0,0,0,0,0,0,125
2014,Cambodia,KHM,-,-,5,25,12,113,0,6144,6299,11,19,5,94,5,6220,6354,13323
2014,Canada,CAN,-,-,0,7,5,7,0,0,19,0,5,11,5,0,0,21,150
2014,Central African Rep.,CAF,-,-,32765,51995,32979,95168,5679,1494,220080,32925,50930,32920,78104,6056,1654,202589,879970
2014,Cayman Islands,CYM,-,-,0,0,0,0,0,0,0,0,0,0,0,0,0,0,6
2014,Chad,TCD,-,-,435,596,743,1117,203,4004,7098,419,531,641,2100,277,4302,8270,86532
2014,China,CHN,-,-,222,227,152,2657,93,1590,4941,184,182,155,3419,105,2406,6451,258128
2014,Chile,CHL,-,-,0,6,5,43,58,45,157,0,0,6,88,75,36,205,669
2014,Cameroon,CMR,-,-,63,91,67,799,28,527,1575,64,71,101,1749,11,1050,3046,15752
2014,Congo,COG,-,-,104,192,158,647,15,4323,5439,106,190,139,1116,51,5068,6670,18009
2014,Dem. Rep. of the Congo,COD,-,-,339448,445187,230365,680921,57585,19494,1773000,340146,444461,235964,553944,35992,24869,1635376,3452998
2014,Comoros,COM,-,-,0,0,0,10,0,173,183,0,5,5,7,0,346,363,928
2014,Colombia,COL,-,-,77,201,491,2030,125,3084640,3087564,97,280,534,3041,127,2964095,2968174,6409155
2014,Costa Rica,CRI,-,-,0,5,0,0,0,0,5,0,0,0,0,0,0,0,539
2014,Cuba,CUB,-,-,5,20,245,605,36,68,979,0,42,67,1450,56,110,1725,9432
2014,Cabo Verde,CPV,-,-,0,0,0,8,0,0,8,5,5,0,15,0,0,25,73
2014,Cyprus,CYP,-,-,0,0,0,0,0,0,0,0,0,0,0,0,0,0,10
2014,Czechia,CZE,-,-,6,13,5,162,179,21,386,6,10,0,236,330,17,599,1418
2014,Denmark,DNK,-,-,0,0,0,0,0,0,0,0,0,0,0,0,0,0,21
2014,Djibouti,DJI,-,-,12,18,31,68,5,78,212,10,20,25,82,0,63,200,1289
2014,Dominica,DMA,-,-,0,0,0,0,0,0,0,0,0,0,0,0,0,0,48
2014,Dominican Rep.,DOM,-,-,0,0,17,254,0,19,290,0,5,11,238,0,0,254,1487
2014,Ecuador,ECU,-,-,5,27,6,44,0,13,95,5,10,6,76,0,16,113,7773
2014,Equatorial Guinea,GNQ,-,-,0,0,5,10,0,15,30,0,0,5,32,0,16,53,249
2014,Eritrea,ERI,-,-,8434,17873,14205,72216,4252,7085,124065,8938,18997,17357,119865,5384,9540,180081,416847
2014,Estonia,EST,-,-,0,0,0,0,0,8,8,0,0,0,5,0,6,11,371
2014,Ethiopia,ETH,-,-,4845,6902,6282,23855,690,5030,47604,5247,7053,5852,29471,804,14948,63375,148632
2014,Fiji,FJI,-,-,0,0,0,5,0,0,5,0,0,0,15,0,0,15,1696
2014,Finland,FIN,-,-,0,0,0,0,0,0,0,0,0,0,0,0,0,0,5
2014,France,FRA,-,-,0,0,0,0,0,0,0,0,5,5,9,5,0,24,124
2014,Gabon,GAB,-,-,0,0,5,10,0,13,28,5,0,5,15,0,18,43,295
2014,Gambia,GMB,-,-,42,38,17,220,0,103,420,36,42,70,2627,5,110,2890,15598
2014,Palestinian,PSE,-,-,7269,9652,6206,19209,1626,156,44118,8064,6798,11226,21955,1506,477,50026,104009
2014,United Kingdom of Great Britain and Northern Ireland,GBR,-,-,0,0,0,11,0,0,11,0,0,0,6,0,0,6,214
2014,Georgia,GEO,-,-,11339,11943,11925,78336,28743,1433,143719,11926,12970,13174,68418,18297,1425,126210,277194
2014,Germany,DEU,-,-,0,0,0,0,0,8,8,0,0,0,0,0,0,0,247
2014,Ghana,GHA,-,-,2301,2736,1075,4648,544,213,11517,2257,2956,1182,4110,252,386,11143,29735
2014,Guinea-Bissau,GNB,-,-,12,17,5,103,0,294,431,5,5,31,891,5,643,1580,3065
2014,Greece,GRC,-,-,0,5,0,5,5,0,15,0,5,0,18,20,0,43,167
2014,Grenada,GRD,-,-,0,0,0,6,0,0,6,0,0,0,0,0,0,0,376
2014,Guatemala,GTM,-,-,6,23,40,137,0,5,211,0,14,25,208,0,10,257,23287
2014,Guinea,GIN,-,-,138,84,115,614,15,2957,3923,93,58,232,2930,12,2458,5783,33060
2014,Guyana,GUY,-,-,0,0,0,6,0,0,6,0,5,0,13,0,8,26,848
2014,Haiti,HTI,-,-,111,247,237,8791,60,1550,10996,130,428,208,21051,97,1973,23887,73106
2014,"China, Hong Kong SAR",HKG,-,-,0,0,0,0,0,0,0,0,0,0,0,0,0,0,63
2014,Honduras,HND,-,-,18,27,40,162,0,0,247,18,45,43,267,0,0,373,14293
2014,Croatia,HRV,-,-,17,331,1194,11545,8014,69,21170,14,368,1097,12616,4584,60,18739,56026
2014,Hungary,HUN,-,-,39,47,30,208,63,24,411,45,61,25,236,167,50,584,1606
2014,Iceland,ISL,-,-,0,0,0,0,0,0,0,0,0,0,0,0,0,0,5
2014,Cote d'Ivoire,CIV,-,-,4911,6809,3893,15833,1055,1206,33707,4739,6861,4282,15534,676,1533,33625,109401
2014,India,IND,-,-,95,103,45,738,0,212,1193,138,115,73,2531,15,213,3085,27510
2014,Indonesia,IDN,-,-,22,5,5,909,0,6,947,25,7,14,10,9,0,65,16158
2014,Ireland,IRL,-,-,0,6,0,0,0,0,6,0,0,0,0,0,0,0,89
2014,Iran (Islamic Rep. of),IRN,-,-,1001,2132,2600,17010,1464,1335,25542,1012,2313,4242,27325,1848,2395,39135,117111
2014,Iraq,IRQ,-,-,10795,17038,16816,50559,5846,4165,105219,11527,18400,17787,72775,5536,5275,131300,4073347
2014,Israel,ISR,-,-,8,5,9,21,0,5,48,5,11,0,51,0,0,67,1249
2014,Italy,ITA,-,-,5,5,6,17,0,7,40,12,0,5,10,0,0,27,173
2014,Jamaica,JAM,-,-,10,7,5,96,0,5,123,0,6,11,99,0,5,121,2279
2014,Jordan,JOR,-,-,38,66,37,278,5,16,440,25,60,43,233,5,40,406,3106
2014,Japan,JPN,-,-,23,44,18,5,0,0,90,42,62,22,5,0,0,131,318
2014,Kazakhstan,KAZ,-,-,29,42,16,116,25,277,505,25,33,35,99,5,216,413,3366
2014,Kenya,KEN,-,-,334,522,461,1415,152,158,3042,321,553,418,1128,140,142,2702,11471
2014,Kyrgyzstan,KGZ,-,-,21,58,25,167,11,224,506,50,68,26,157,0,239,540,4283
2014,Kiribati,KIR,-,-,0,0,0,0,0,0,0,0,0,0,0,0,0,0,5
2014,Rep. of Korea,KOR,-,-,8,16,27,21,0,0,72,15,21,24,24,0,5,89,760
2014,Dem. People's Rep. of Korea,PRK,-,-,7,0,0,61,10,78,156,0,7,0,72,5,85,169,1508
2014,Kuwait,KWT,-,-,10,20,15,13,0,0,58,0,7,10,21,0,9,47,1234
2014,Lao People's Dem. Rep.,LAO,-,-,0,0,0,6,5,3411,3422,0,0,0,36,5,3768,3809,7589
2014,Liberia,LBR,-,-,425,793,814,3215,136,108,5491,382,846,799,3751,187,253,6218,15888
2014,Libya,LBY,-,-,101,118,63,303,0,91,676,101,147,69,789,9,174,1289,371145
2014,Saint Lucia,LCA,-,-,0,0,5,16,0,0,21,0,6,0,6,0,0,12,956
2014,Lebanon,LBN,-,-,82,123,131,624,59,41,1060,108,149,164,1594,43,126,2184,8095
2014,Lesotho,LSO,-,-,0,0,0,5,0,5,10,0,0,0,0,0,0,0,681
2014,Sri Lanka,LKA,-,-,259,397,270,2550,442,41091,45009,268,399,362,8639,269,50106,60043,170064
2014,Lithuania,LTU,-,-,0,0,0,6,0,0,6,0,0,0,0,0,17,17,239
2014,Latvia,LVA,-,-,0,0,0,5,0,21,26,0,5,0,17,0,20,42,263
2014,"China, Macao SAR",MAC,-,-,0,0,0,0,0,0,0,0,0,0,0,0,5,5,16
2014,Madagascar,MDG,-,-,0,5,0,17,0,103,125,0,0,6,0,0,111,117,484
2014,Mauritania,MRT,-,-,2907,3382,1875,4875,424,1162,14625,3112,3383,1872,4675,443,3896,17381,41105
2014,North Macedonia,MKD,-,-,524,673,503,2043,49,179,3971,634,695,524,1989,57,191,4090,9540
2014,Monaco,MCO,-,-,0,0,0,0,0,0,0,0,0,0,0,0,0,0,11
2014,Rep. of Moldova,MDA,-,-,6,11,5,84,5,179,290,10,10,15,183,0,182,400,3670
2014,Maldives,MDV,-,-,0,5,0,0,0,0,5,0,0,0,5,0,0,5,37
2014,Mexico,MEX,-,-,5,10,22,61,0,5,103,0,5,19,58,0,6,88,40023
2014,Marshall Islands,MHL,-,-,0,0,0,0,0,0,0,0,0,0,0,0,0,0,11
2014,Mali,MLI,-,-,10476,19074,7944,29500,2868,3035,72897,10605,18890,7991,20525,2487,989,61487,251295
2014,Malaysia,MYS,-,-,0,7,0,0,0,7,14,0,0,0,5,0,0,5,1406
2014,Malawi,MWI,-,-,0,0,0,0,0,10,10,0,0,0,0,0,13,13,4247
2014,Mongolia,MNG,-,-,63,24,12,310,6,214,629,65,38,24,251,0,145,523,4366
2014,Morocco,MAR,-,-,35,24,18,317,7,74,475,38,23,77,1577,10,224,1949,4757
2014,Mozambique,MOZ,-,-,6,0,6,15,0,10,37,0,7,0,17,0,5,29,1463
2014,Montenegro,MNE,-,-,96,111,85,323,19,91,725,103,141,85,296,11,90,726,1874
2014,Mauritius,MUS,-,-,0,0,0,0,0,5,5,0,0,0,0,0,5,5,242
2014,Myanmar,MMR,-,-,12492,12278,9597,53339,2897,644,91247,13091,13157,11590,107287,2920,1583,149628,907245
2014,Namibia,NAM,-,-,43,54,48,136,0,5,286,51,68,35,557,34,0,745,1295
2014,Nepal,NPL,-,-,0,17,0,85,0,26,128,0,0,11,336,0,105,452,15186
2014,Netherlands (Kingdom of the),NLD,-,-,5,0,0,5,0,0,10,5,6,0,5,0,0,16,103
2014,Niger,NER,-,-,6,5,15,14,0,17,57,8,5,15,204,0,39,271,1263
2014,Nicaragua,NIC,-,-,0,0,0,92,18,0,110,0,0,0,159,7,0,166,2298
2014,Nigeria,NGA,-,-,1376,1057,916,3673,74,630660,637756,1311,992,861,6518,102,558655,568439,1379042
2014,Niue,NIU,-,-,0,0,0,0,0,0,0,0,0,0,0,0,0,0,46
2014,Norway,NOR,-,-,0,0,0,0,0,0,0,0,0,0,0,0,0,0,15
2014,New Zealand,NZL,-,-,0,0,0,0,0,0,0,0,0,0,9,0,0,9,27
2014,Oman,OMN,-,-,0,0,0,0,0,0,0,0,0,0,0,0,5,5,34
2014,Pakistan,PAK,-,-,144268,164089,91860,379635,17064,209,797125,158103,208216,130655,355855,33540,1127,887496,1756270
2014,Panama,PAN,-,-,0,0,0,0,0,0,0,0,0,6,0,0,0,6,111
2014,Paraguay,PRY,-,-,0,0,0,8,0,0,8,0,0,0,15,0,5,20,121
2014,Peru,PER,-,-,0,0,45,517,64,125,751,0,7,61,569,65,174,876,5362
2014,Philippines,PHL,-,-,10,13,26,237,5,72644,72935,15,9,5,29,0,69796,69854,224260
2014,Papua New Guinea,PNG,-,-,0,0,0,0,0,0,0,0,0,0,0,0,0,0,498
2014,Poland,POL,-,-,6,5,6,107,101,72,297,0,5,11,246,269,89,620,1569
2014,Portugal,PRT,-,-,0,0,0,0,0,5,5,0,0,0,5,5,0,10,64
2014,Qatar,QAT,-,-,0,0,0,0,0,0,0,0,0,0,0,0,0,0,28
2014,Romania,ROU,-,-,5,13,15,44,35,80,192,7,8,10,80,85,99,289,2933
2014,South Africa,ZAF,-,-,0,13,0,37,0,6,56,0,12,5,195,10,18,240,953
2014,Russian Federation,RUS,-,-,1349,1794,994,5031,315,7316,16799,1523,2000,1175,4829,195,6908,16630,95052
2014,Rwanda,RWA,-,-,5648,9720,6630,17982,1035,2398,43413,5785,9396,6624,19530,1090,2428,44853,94260
2014,El Salvador,SLV,-,-,18,37,53,273,36,6,423,34,26,30,371,55,12,528,29003
2014,Saudi Arabia,SAU,-,-,5,0,20,24,0,5,54,5,16,5,46,0,0,72,1008
2014,Serbia and Kosovo: S/RES/1244 (1999),SRB,-,-,3394,12322,15127,78950,24835,6402,141030,3502,13036,16448,81962,20439,7181,142568,314442
2014,Senegal,SEN,-,-,1205,2690,1925,4216,533,476,11045,1181,2848,1879,6720,457,262,13347,31827
2014,Seychelles,SYC,-,-,0,0,0,0,0,5,5,0,0,0,0,0,0,0,35
2014,Singapore,SGP,-,-,0,0,0,0,0,0,0,0,7,0,0,0,0,7,86
2014,Sierra Leone,SLE,-,-,63,106,116,501,22,186,994,53,95,106,1182,16,343,1795,9618
2014,Solomon Islands,SLB,-,-,0,0,0,0,0,5,5,0,0,0,0,0,7,7,90
2014,Somalia,SOM,-,-,63707,114832,68603,223383,13519,9145,493189,66151,119483,76343,251942,12588,36439,562946,2289294
2014,Spain,ESP,-,-,0,7,5,10,0,0,22,5,6,5,13,0,5,34,128
2014,Viet Nam,VNM,-,-,66,119,79,1064,159,148170,149657,90,100,74,1666,176,162288,164394,316620
2014,Saint Kitts and Nevis,KNA,-,-,0,0,0,9,0,0,9,0,7,0,0,0,0,7,27
2014,Sao Tome and Principe,STP,-,-,0,0,5,11,0,0,16,8,0,0,0,0,5,13,29
2014,Sudan,SDN,-,-,61048,77174,57516,138332,11606,1096900,1442576,62864,76832,61241,107343,9627,1099134,1417041,2894818
2014,Suriname,SUR,-,-,0,0,0,0,0,0,0,0,0,0,5,0,0,5,63
2014,South Sudan,SSD,-,-,49258,79784,46993,120091,8641,25268,330035,50607,83004,54941,77243,4277,19637,289709,2265364
2014,Slovakia,SVK,-,-,29,27,8,114,15,61,254,28,21,30,133,34,59,305,643
2014,Slovenia,SVN,-,-,0,0,0,0,0,0,0,0,0,0,0,9,0,9,30
2014,Eswatini,SWZ,-,-,0,0,0,5,0,5,10,0,0,0,5,0,7,12,296
2014,Sweden,SWE,-,-,5,0,0,5,0,0,10,0,0,0,0,0,0,0,28
2014,Switzerland,CHE,-,-,0,0,0,0,0,0,0,0,0,0,0,0,0,0,16
2014,Syrian Arab Rep.,SYR,-,-,211178,246805,182954,568315,41882,2690,1253824,220262,260130,193991,537971,33187,5051,1250592,11601631
2014,United Rep. of Tanzania,TZA,-,-,16,28,15,79,0,29,167,8,26,5,126,0,26,191,1899
2014,Turks and Caicos Islands,TCA,-,-,0,0,0,0,0,0,0,0,0,0,0,0,0,0,15
2014,Thailand,THA,-,-,0,15,19,33,0,0,67,0,9,20,16,0,0,45,633
2014,Tajikistan,TJK,-,-,32,83,20,116,5,18,274,35,65,69,258,0,27,454,1560
2014,Turkmenistan,TKM,-,-,38,35,17,292,7,6,395,41,39,13,176,0,17,286,1213
2014,Timor-Leste,TLS,-,-,0,0,0,0,0,0,0,0,0,0,0,0,0,0,20
2014,Togo,TGO,-,-,233,366,257,1232,54,544,2686,236,381,256,2332,91,861,4157,10962
2014,Tonga,TON,-,-,0,0,0,0,0,0,0,0,0,0,0,0,0,0,101
2014,Trinidad and Tobago,TTO,-,-,0,0,0,17,0,0,17,0,0,0,0,0,0,0,544
2014,Tunisia,TUN,-,-,6,42,17,142,0,169,376,17,19,50,798,10,436,1330,3269
2014,Türkiye,TUR,-,-,1835,2801,2022,11186,2081,4110,24035,1813,2789,2228,17351,1734,9797,35712,75082
2014,United Arab Emirates,ARE,-,-,0,0,0,0,0,0,0,0,0,0,9,0,0,9,152
2014,Uganda,UGA,-,-,225,317,269,1155,43,236,2245,234,323,237,1087,26,568,2475,191925
2014,Ukraine,UKR,-,-,197,350,170,1598,224,697636,700175,239,293,197,1557,99,357969,360354,1075707
2014,Uruguay,URY,-,-,0,0,0,0,0,0,0,0,0,0,0,0,0,0,161
2014,United States of America,USA,-,-,26,59,30,30,5,0,150,25,59,37,40,8,0,169,5161
2014,Uzbekistan,UZB,-,-,36,50,97,313,6,189,691,42,43,97,245,5,171,603,6770
2014,Saint Vincent and the Grenadines,VCT,-,-,0,0,5,37,0,0,42,8,0,0,22,0,0,30,1781
2014,Venezuela (Bolivarian Republic of),VEN,-,-,20,19,22,155,0,6,222,11,19,13,324,0,6,373,12831
2014,Samoa,WSM,-,-,0,0,0,0,0,0,0,0,0,0,0,0,0,0,7
2014,Western Sahara,ESH,-,-,0,0,0,18,0,23,41,0,0,0,238,0,174,412,117654
2014,Yemen,YEM,-,-,13772,48520,30720,69774,3925,100,166811,13646,51669,36398,63622,4696,123,170154,339445
2014,Zambia,ZMB,-,-,0,0,0,11,0,57,68,0,0,0,11,0,28,39,602
2014,Zimbabwe,ZWE,-,-,87,89,72,366,14,2704,3332,81,87,59,542,10,3620,4399,65013
2014,Stateless,XXA,-,-,114,194,153,685,65,34,1245,130,250,207,1416,95,95,2193,38439
2014,Tibetan,TIB,-,-,0,0,0,5,0,7500,7505,0,0,5,0,0,7500,7505,15081
2014,Guadeloupe,GLP,-,-,0,0,0,0,0,0,0,0,0,0,0,0,0,0,12
2014,Curacao ,CUW,-,-,0,0,0,0,0,0,0,0,0,0,0,0,0,0,35
2014,Unknown ,UNK,-,-,1178,2299,1729,9913,766,114718,130603,1276,2377,1793,13475,1042,280117,300080,573337
2015,Afghanistan,AFG,-,-,189674,328776,261575,638919,48179,4181,1471304,195971,353590,294227,741878,70047,11792,1667505,4249831
2015,Albania,ALB,-,-,2049,2214,1413,8563,118,1743,16100,2232,2507,1857,12332,132,1863,20923,52559
2015,Algeria,DZA,-,-,57,48,32,402,15,660,1214,57,49,93,3479,29,945,4652,11104
2015,Andorra,AND,-,-,0,0,0,0,0,0,0,0,0,0,0,0,0,0,10
2015,Angola,AGO,-,-,3374,4301,2303,9042,697,1499,21216,3181,4208,2330,8367,957,3692,22735,50071
2015,Antigua and Barbuda,ATG,-,-,0,0,0,0,0,0,0,0,0,0,7,0,0,7,68
2015,Egypt,EGY,-,-,190,294,169,849,33,252,1787,191,340,281,3547,54,660,5073,30149
2015,Argentina,ARG,-,-,0,6,0,10,0,5,21,0,5,0,25,0,0,30,346
2015,Armenia,ARM,-,-,231,275,215,2004,272,2231,5228,294,368,285,2093,219,2170,5429,19716
2015,Australia,AUS,-,-,0,0,0,0,0,0,0,0,5,0,0,0,0,5,21
2015,Austria,AUT,-,-,0,0,0,0,0,0,0,0,0,0,0,0,0,0,5
2015,Azerbaijan,AZE,-,-,230,309,166,2249,516,1630,5100,260,408,222,2317,314,1512,5033,633139
2015,Bahrain,BHR,-,-,0,11,10,9,0,0,30,5,11,7,52,0,5,80,503
2015,Barbados,BRB,-,-,0,0,0,5,0,0,5,0,0,0,11,0,0,11,119
2015,Burundi,BDI,-,-,36495,53339,43604,111351,7925,355,253069,36803,51138,41292,108188,6696,381,244498,508626
2015,Belgium,BEL,-,-,5,0,12,0,0,0,17,0,0,5,5,0,0,10,103
2015,Benin,BEN,-,-,9,0,5,100,0,37,151,5,16,24,638,0,30,713,1547
2015,Bangladesh,BGD,-,-,41,49,18,268,5,510,891,55,65,51,3672,18,3601,7462,42714
2015,Bahamas,BHS,-,-,0,0,0,15,0,0,15,0,7,0,20,0,0,27,296
2015,Bhutan,BTN,-,-,824,1170,964,4668,565,17,8208,875,1219,1017,5159,780,102,9152,17932
2015,Burkina Faso,BFA,-,-,9,0,0,61,0,102,172,5,0,17,429,0,89,540,4838
2015,Belarus,BLR,-,-,17,20,24,198,8,285,552,24,34,49,229,16,342,694,5589
2015,Bolivia (Plurinational State of),BOL,-,-,0,18,12,65,5,17,117,0,25,0,103,7,18,153,908
2015,Botswana,BWA,-,-,0,10,0,15,0,0,25,0,0,0,0,0,0,0,379
2015,Brazil,BRA,-,-,0,7,5,33,0,11,56,5,5,15,31,0,5,61,3044
2015,Brunei Darussalam,BRN,-,-,0,0,0,0,0,0,0,0,0,0,0,0,0,0,5
2015,Bosnia and Herzegovina,BIH,-,-,412,572,515,4685,2265,76767,85216,458,623,639,4977,1347,80009,88053,176539
2015,Bulgaria,BGR,-,-,0,5,5,41,13,37,101,0,0,10,47,42,55,154,1471
2015,Belize,BLZ,-,-,0,0,0,0,0,0,0,0,0,0,0,0,0,0,201
2015,Cambodia,KHM,-,-,5,15,24,119,5,6053,6221,10,11,24,104,5,6122,6276,13174
2015,Canada,CAN,-,-,0,7,0,5,0,0,12,0,8,6,0,0,0,14,413
2015,Central African Rep.,CAF,-,-,39299,62786,38076,104835,6313,130573,381882,39292,61753,36327,84354,6363,87462,315551,718911
2015,Cayman Islands,CYM,-,-,0,0,0,0,0,0,0,0,0,0,0,0,0,0,6
2015,Chad,TCD,-,-,1085,1507,1020,3024,315,376,7327,1156,1385,988,3209,258,52939,59935,100187
2015,China,CHN,-,-,107,165,126,2176,68,2277,4919,94,150,108,2603,116,3147,6218,270604
2015,Chile,CHL,-,-,0,0,5,76,36,60,177,0,0,0,90,75,59,224,703
2015,Cameroon,CMR,-,-,130,167,80,1075,30,47710,49192,110,149,129,2290,28,46316,49022,110584
2015,Congo,COG,-,-,126,160,142,685,18,1622,2753,89,170,154,1178,49,1721,3361,18931
2015,Dem. Rep. of the Congo,COD,-,-,218134,250325,128243,448087,25508,7300,1077597,215169,248149,135707,398753,21162,8183,1027123,2182551
2015,Comoros,COM,-,-,0,0,0,5,0,187,192,0,6,0,5,0,338,349,776
2015,Colombia,COL,-,-,149,3823,10668,10887,724,3341,29592,172,3893,10580,14537,976,3813,33971,7286062
2015,Costa Rica,CRI,-,-,0,5,0,0,0,0,5,0,0,0,0,0,0,0,587
2015,Cuba,CUB,-,-,0,10,57,762,53,71,953,0,27,43,1545,83,128,1826,9255
2015,Cabo Verde,CPV,-,-,0,5,0,24,0,0,29,0,10,0,44,0,0,54,122
2015,Cyprus,CYP,-,-,0,0,0,0,0,0,0,0,0,0,0,0,0,0,5
2015,Czechia,CZE,-,-,0,12,14,189,178,12,405,8,5,13,259,342,29,656,1399
2015,Denmark,DNK,-,-,0,0,0,0,0,0,0,0,0,0,0,0,0,0,26
2015,Djibouti,DJI,-,-,0,23,8,61,5,223,320,0,23,7,74,0,162,266,1601
2015,Dominica,DMA,-,-,0,0,0,0,0,0,0,0,0,0,0,0,0,0,124
2015,Dominican Rep.,DOM,-,-,0,5,14,251,6,25,301,0,5,6,561,0,5,577,2091
2015,Ecuador,ECU,-,-,0,22,16,35,0,13,86,0,6,9,78,0,15,108,11421
2015,Equatorial Guinea,GNQ,-,-,5,0,0,5,0,15,25,0,5,0,26,5,15,51,227
2015,Eritrea,ERI,-,-,9044,18450,14103,78438,4443,6221,130699,9735,19558,19855,138950,5709,6408,200215,469751
2015,Estonia,EST,-,-,0,0,0,0,0,8,8,0,0,0,7,0,0,7,354
2015,Ethiopia,ETH,-,-,4886,6956,4644,26909,723,653,44771,5279,7298,5212,31511,840,644,50784,162740
2015,Fiji,FJI,-,-,0,0,0,0,0,0,0,0,0,0,15,0,0,15,1316
2015,Finland,FIN,-,-,0,0,0,0,0,0,0,0,0,0,0,0,0,0,10
2015,France,FRA,-,-,0,0,0,6,0,0,6,0,5,0,23,5,0,33,167
2015,Micronesia (Federated States of),FSM,-,-,0,0,0,0,0,0,0,0,0,0,0,0,0,0,6
2015,Gabon,GAB,-,-,0,0,0,17,0,26,43,0,0,0,10,0,26,36,398
2015,Gambia,GMB,-,-,65,48,19,305,0,136,573,48,37,139,5146,5,104,5479,21293
2015,Palestinian,PSE,-,-,6987,9572,6081,19309,1718,217,43884,7734,6755,11254,21790,1583,533,49649,104748
2015,United Kingdom of Great Britain and Northern Ireland,GBR,-,-,0,0,0,5,0,0,5,0,0,0,7,0,0,7,237
2015,Georgia,GEO,-,-,11633,12951,11997,79177,29734,1510,147002,12234,13949,13289,69912,18835,1464,129683,284166
2015,Germany,DEU,-,-,0,0,0,0,0,7,7,0,0,0,0,0,0,0,239
2015,Ghana,GHA,-,-,2307,2746,1075,4893,551,210,11782,2268,2974,1156,3890,257,384,10929,33667
2015,Guinea-Bissau,GNB,-,-,11,17,11,129,0,314,482,5,5,34,858,5,636,1543,3393
2015,Greece,GRC,-,-,0,0,6,5,5,0,16,0,12,0,14,23,0,49,176
2015,Grenada,GRD,-,-,0,0,0,0,0,0,0,5,0,0,0,0,0,5,321
2015,Guatemala,GTM,-,-,5,12,19,30,5,696,767,6,12,16,66,0,2833,2933,40735
2015,Guinea,GIN,-,-,119,130,70,720,5,5454,6498,103,86,249,3101,12,3784,7335,34827
2015,Guyana,GUY,-,-,0,0,0,9,0,5,14,0,8,0,13,0,8,29,731
2015,Haiti,HTI,-,-,31,245,161,1393,51,1518,3399,27,216,144,5699,76,1932,8094,50289
2015,"China, Hong Kong SAR",HKG,-,-,0,0,0,0,0,0,0,0,5,0,0,0,0,5,113
2015,Honduras,HND,-,-,10005,12721,13734,50125,4300,0,90885,11105,15915,12533,45462,3600,0,88615,205403
2015,Croatia,HRV,-,-,86,342,1078,9739,6419,7366,25030,67,359,1060,10511,3511,6798,22306,47611
2015,Hungary,HUN,-,-,28,37,41,187,64,41,398,26,37,37,219,172,88,579,2155
2015,Iceland,ISL,-,-,0,0,0,0,0,0,0,0,0,0,0,0,0,0,5
2015,Cote d'Ivoire,CIV,-,-,4304,6995,4284,14652,1015,1384,32634,4179,6902,4633,14671,645,1576,32606,393175
2015,India,IND,-,-,103,112,59,1142,11,66,1493,139,128,92,3844,24,199,4426,35134
2015,Indonesia,IDN,-,-,21,0,6,1094,0,6,1127,26,13,0,5,8,0,52,16584
2015,Ireland,IRL,-,-,0,6,0,0,0,0,6,0,0,0,0,0,0,0,41
2015,Iran (Islamic Rep. of),IRN,-,-,1285,2544,2288,20245,1543,1903,29808,1332,2825,2893,33448,2018,2887,45403,142039
2015,Iraq,IRQ,-,-,14497,23325,16070,75861,8298,5090,143141,15471,25521,18924,112392,7909,8030,188247,4908139
2015,Israel,ISR,-,-,0,9,7,27,5,5,53,0,7,5,48,0,15,75,1166
2015,Italy,ITA,-,-,8,0,6,20,0,0,34,8,0,6,18,0,6,38,208
2015,Jamaica,JAM,-,-,0,0,14,63,0,5,82,6,12,0,69,0,8,95,2696
2015,Jordan,JOR,-,-,31,64,32,354,10,30,521,24,58,56,327,5,54,524,3757
2015,Japan,JPN,-,-,6,26,9,5,0,0,46,13,30,12,5,0,0,60,208
2015,Kazakhstan,KAZ,-,-,13,36,13,132,29,299,522,22,32,23,164,5,256,502,3828
2015,Kenya,KEN,-,-,325,442,357,1262,153,69,2608,359,471,342,965,127,43,2307,11172
2015,Kyrgyzstan,KGZ,-,-,25,43,26,218,10,185,507,25,68,43,178,0,195,509,4761
2015,Kiribati,KIR,-,-,0,0,0,0,0,0,0,0,0,0,0,0,0,0,5
2015,Rep. of Korea,KOR,-,-,0,10,14,29,0,0,53,8,7,13,25,0,0,53,598
2015,Dem. People's Rep. of Korea,PRK,-,-,5,6,0,69,0,34,114,0,9,0,82,5,29,125,1317
2015,Kuwait,KWT,-,-,0,5,18,30,0,0,53,0,7,0,50,0,16,73,1507
2015,Lao People's Dem. Rep.,LAO,-,-,0,0,0,5,6,3383,3394,0,0,0,38,6,3710,3754,7524
2015,Liberia,LBR,-,-,294,546,488,2436,81,89,3934,264,529,541,2821,128,187,4470,12394
2015,Libya,LBY,-,-,159,184,102,555,5,152,1157,130,222,130,1461,24,216,2183,446993
2015,Saint Lucia,LCA,-,-,0,0,0,5,0,0,5,0,0,0,7,0,0,7,1071
2015,Lebanon,LBN,-,-,122,191,130,943,80,98,1564,148,236,178,2333,47,178,3120,10338
2015,Lesotho,LSO,-,-,0,0,0,5,0,0,5,0,0,0,5,0,0,5,1107
2015,Sri Lanka,LKA,-,-,237,324,233,2344,431,40935,44504,236,336,369,7565,263,49033,57802,181160
2015,Lithuania,LTU,-,-,0,0,0,10,0,0,10,0,0,0,9,0,19,28,207
2015,Latvia,LVA,-,-,0,0,0,11,0,20,31,0,0,0,17,0,19,36,264
2015,"China, Macao SAR",MAC,-,-,0,0,0,0,0,0,0,0,0,0,0,0,0,0,30
2015,Madagascar,MDG,-,-,0,5,0,16,0,109,130,0,0,0,5,0,112,117,456
2015,Mauritania,MRT,-,-,2528,3444,1977,5472,444,1239,15104,2614,3493,1905,5234,522,4038,17806,42135
2015,North Macedonia,MKD,-,-,767,908,614,2882,79,266,5516,851,1024,735,2888,87,269,5854,16378
2015,Monaco,MCO,-,-,0,0,0,0,0,0,0,0,0,0,0,0,0,0,5
2015,Rep. of Moldova,MDA,-,-,78,82,35,512,17,174,898,90,86,49,826,14,183,1248,5726
2015,Maldives,MDV,-,-,0,5,0,0,0,0,5,0,0,0,0,0,0,0,67
2015,Mexico,MEX,-,-,0,12,5,48,0,6,71,5,5,16,37,0,15,78,57590
2015,Marshall Islands,MHL,-,-,0,0,0,0,0,0,0,0,0,0,0,0,0,0,11
2015,Mali,MLI,-,-,10348,20813,9653,32297,3029,3195,79335,10605,20682,9610,22435,2760,959,67051,226027
2015,Malaysia,MYS,-,-,0,6,0,5,0,12,23,0,0,5,5,0,0,10,3258
2015,Malawi,MWI,-,-,20,5,6,85,0,0,116,6,5,5,76,0,0,92,6101
2015,Mongolia,MNG,-,-,65,34,18,313,11,227,668,66,54,21,262,5,157,565,5727
2015,Morocco,MAR,-,-,38,40,11,465,5,101,660,38,22,79,2132,11,246,2528,7346
2015,Mozambique,MOZ,-,-,0,0,6,19,0,5,30,0,0,0,52,0,5,57,2248
2015,Malta,MLT,-,-,0,0,0,0,0,0,0,0,0,0,0,0,0,0,5
2015,Montenegro,MNE,-,-,228,280,184,776,28,73,1569,241,308,173,783,19,66,1590,3661
2015,Mauritius,MUS,-,-,11,6,0,18,0,5,40,0,0,7,23,0,5,35,303
2015,Myanmar,MMR,-,-,33035,29716,23762,99793,8184,59,194549,32926,30989,27680,145272,7423,295,244585,963968
2015,Namibia,NAM,-,-,43,64,44,135,0,0,286,33,85,39,508,30,0,695,1368
2015,Nepal,NPL,-,-,5,0,0,87,0,46,138,0,10,5,460,0,103,578,18012
2015,Netherlands (Kingdom of the),NLD,-,-,5,0,0,6,0,0,11,0,0,0,6,0,0,6,119
2015,Niger,NER,-,-,38,45,40,115,19,114511,114768,38,60,33,346,7,92971,93455,209483
2015,Nicaragua,NIC,-,-,0,0,5,180,24,0,209,0,0,0,387,12,0,399,2706
2015,Nigeria,NGA,-,-,6076,7463,3568,15777,971,38485,72340,6176,7502,3530,16759,990,31251,66208,2391877
2015,Niue,NIU,-,-,0,0,0,0,0,0,0,0,0,0,0,0,0,0,36
2015,Norway,NOR,-,-,0,5,0,0,0,0,5,0,0,0,0,0,0,0,15
2015,New Zealand,NZL,-,-,0,0,0,0,0,0,0,0,0,0,8,0,0,8,23
2015,Oman,OMN,-,-,0,0,0,0,0,0,0,0,5,0,0,0,0,5,52
2015,Pakistan,PAK,-,-,116774,135871,84305,289362,28649,248,655209,136211,182349,108983,306392,30126,1454,765515,1507949
2015,Panama,PAN,-,-,0,5,5,0,0,0,10,0,0,0,0,0,0,0,121
2015,Paraguay,PRY,-,-,5,0,0,18,0,0,23,0,0,0,36,0,5,41,155
2015,Peru,PER,-,-,0,9,53,495,68,143,768,0,10,51,580,80,166,887,5121
2015,Philippines,PHL,-,-,19,11,0,367,10,32219,32626,8,14,11,121,0,30955,31109,145699
2015,Papua New Guinea,PNG,-,-,0,0,0,0,0,0,0,0,0,0,0,0,0,0,533
2015,Poland,POL,-,-,7,0,14,118,107,136,382,0,7,0,249,286,180,722,1697
2015,Portugal,PRT,-,-,8,0,0,5,0,5,18,0,5,0,10,5,0,20,92
2015,Qatar,QAT,-,-,0,0,0,0,0,0,0,0,0,0,0,0,0,0,33
2015,Romania,ROU,-,-,0,0,16,160,47,83,306,5,7,16,237,105,114,484,3108
2015,South Africa,ZAF,-,-,11,23,10,148,0,9,201,10,14,12,417,8,26,487,1296
2015,Russian Federation,RUS,-,-,1302,1892,1038,5166,374,8784,18556,1418,2078,1162,4883,234,8351,18126,94521
2015,Rwanda,RWA,-,-,29546,37806,25958,50715,2728,1944,148697,26081,38603,27161,50274,3485,1785,147389,303106
2015,El Salvador,SLV,-,-,35,66,437,2487,205,12,3242,46,49,495,7631,263,12,8496,56328
2015,Saudi Arabia,SAU,-,-,5,11,10,51,0,5,82,0,19,0,25,0,0,44,1257
2015,Serbia and Kosovo: S/RES/1244 (1999),SRB,-,-,3648,12448,15126,78332,24055,6173,139782,3874,13329,16340,83366,19818,6886,143613,311914
2015,Senegal,SEN,-,-,467,818,556,2038,225,645,4749,418,850,603,9056,283,598,11808,35568
2015,Seychelles,SYC,-,-,0,5,0,0,0,0,5,0,0,0,0,0,0,0,39
2015,Singapore,SGP,-,-,0,0,0,5,0,0,5,0,0,6,5,0,0,11,95
2015,Sierra Leone,SLE,-,-,73,90,115,573,20,207,1078,44,91,135,1515,20,1799,3604,9865
2015,Solomon Islands,SLB,-,-,0,0,0,0,0,0,0,0,0,0,0,0,0,0,108
2015,Somalia,SOM,-,-,189805,234976,151612,457233,31358,3513,1068497,183830,247404,158727,470882,30545,4393,1095781,2313636
2015,Spain,ESP,-,-,0,17,5,10,0,0,32,0,13,0,15,9,0,37,145
2015,Viet Nam,VNM,-,-,77,136,88,1208,175,3660,5344,109,125,115,1883,194,4592,7018,317790
2015,Saint Kitts and Nevis,KNA,-,-,0,0,0,0,0,0,0,0,5,0,0,0,0,5,45
2015,Sao Tome and Principe,STP,-,-,0,0,5,11,0,0,16,8,0,0,5,0,5,18,34
2015,Sudan,SDN,-,-,52686,79034,48621,140777,11788,700,333606,54624,79679,48625,111411,9304,3883,307526,3888243
2015,Suriname,SUR,-,-,0,0,0,0,0,0,0,0,0,0,0,0,0,0,68
2015,South Sudan,SSD,-,-,60469,90719,56081,131411,9761,740268,1088709,61955,95174,63111,80908,4167,1082035,1387350,2573283
2015,Slovakia,SVK,-,-,41,33,22,158,18,57,329,36,49,30,180,34,57,386,866
2015,Slovenia,SVN,-,-,0,0,0,0,0,0,0,0,0,0,0,7,0,7,31
2015,Eswatini,SWZ,-,-,0,0,0,9,0,0,9,0,0,0,16,0,0,16,372
2015,Sweden,SWE,-,-,0,0,0,5,0,0,5,0,0,0,5,0,0,5,33
2015,Switzerland,CHE,-,-,0,0,0,0,0,0,0,0,0,0,0,0,0,0,16
2015,Syrian Arab Rep.,SYR,-,-,176982,228104,133453,537172,37210,5288,1118209,185521,241972,146347,587969,29838,8123,1199770,11690802
2015,United Rep. of Tanzania,TZA,-,-,19,25,31,79,0,45,199,11,21,12,215,0,27,286,2402
2015,Turks and Caicos Islands,TCA,-,-,0,0,0,0,0,0,0,0,0,0,0,0,0,0,14
2015,Thailand,THA,-,-,0,8,15,89,0,0,112,0,5,13,50,0,5,73,1042
2015,Tajikistan,TJK,-,-,37,107,21,190,5,32,392,40,86,55,366,5,35,587,2241
2015,Turkmenistan,TKM,-,-,54,58,22,467,17,18,636,50,56,32,270,7,21,436,1651
2015,Timor-Leste,TLS,-,-,0,0,0,0,0,0,0,0,0,0,0,0,0,0,24
2015,Togo,TGO,-,-,220,356,297,1280,75,288,2516,248,454,239,2515,121,600,4177,10902
2015,Tonga,TON,-,-,0,0,0,0,0,0,0,0,0,0,0,0,0,0,84
2015,Trinidad and Tobago,TTO,-,-,0,0,5,0,0,0,5,5,0,0,6,0,0,11,569
2015,Tunisia,TUN,-,-,36,35,55,191,0,81,398,47,46,51,989,12,242,1387,3890
2015,Türkiye,TUR,-,-,528,1709,2075,12075,2361,3201,21949,593,1793,2281,17206,2021,8150,32044,71630
2015,United Arab Emirates,ARE,-,-,0,0,11,0,0,0,11,0,0,0,9,0,0,9,194
2015,Uganda,UGA,-,-,18130,18156,18143,19097,18010,80,91616,18119,18139,18143,19423,18029,87,91940,192737
2015,Ukraine,UKR,-,-,403,533,286,2728,320,818,5088,464,565,316,2759,136,645,4885,1943754
2015,Uruguay,URY,-,-,0,0,0,5,0,0,5,0,0,0,0,0,0,0,146
2015,United States of America,USA,-,-,31,53,33,20,10,0,147,30,29,33,44,10,0,146,5079
2015,Uzbekistan,UZB,-,-,30,77,55,434,6,156,758,26,63,85,286,5,141,606,6856
2015,Saint Vincent and the Grenadines,VCT,-,-,0,0,0,12,0,0,12,0,0,0,15,0,0,15,1866
2015,Venezuela (Bolivarian Republic of),VEN,-,-,26,103,32,453,7,21,642,22,82,22,946,6,17,1095,22542
2015,Samoa,WSM,-,-,0,0,0,0,0,0,0,0,0,0,0,0,0,0,9
2015,Western Sahara,ESH,-,-,0,0,0,17,0,38,55,0,0,0,169,0,266,435,117980
2015,Yemen,YEM,-,-,110384,370726,233632,620168,41411,59,1376380,94127,327825,234231,474360,46932,90,1177565,2558001
2015,Zambia,ZMB,-,-,0,5,0,11,0,0,16,0,0,0,11,0,0,11,761
2015,Zimbabwe,ZWE,-,-,73,119,73,539,8,13,825,81,110,68,545,11,21,836,78843
2015,Stateless,XXA,-,-,213,353,231,1288,101,63,2249,231,457,375,3194,166,98,4521,56016
2015,Tibetan,TIB,-,-,0,0,0,7500,0,0,7500,0,0,0,7511,0,0,7511,15085
2015,Guadeloupe,GLP,-,-,0,0,0,0,0,0,0,0,0,0,0,0,0,0,23
2015,Curacao ,CUW,-,-,0,0,0,0,0,0,0,0,0,0,0,0,0,0,35
2015,Unknown ,UNK,-,-,1537,2191,1549,11172,2042,9135,27626,1748,2484,2155,18848,2244,19229,46708,1181681
2016,Afghanistan,AFG,-,-,279667,351603,283722,702496,69095,3550,1690133,306880,355761,330722,854745,90529,11676,1950313,4782291
2016,Albania,ALB,-,-,881,832,640,3288,65,2145,7851,1001,980,843,4103,67,2229,9223,34820
2016,Algeria,DZA,-,-,84,50,43,426,12,728,1343,85,66,91,3075,29,1046,4392,10889
2016,Andorra,AND,-,-,0,0,0,0,0,0,0,0,0,0,0,0,0,0,5
2016,Angola,AGO,-,-,1631,2697,1657,5518,535,2411,14449,1490,2517,1713,5659,855,3589,15823,33112
2016,Antigua and Barbuda,ATG,-,-,0,0,0,8,0,0,8,0,0,0,9,0,0,9,112
2016,Egypt,EGY,-,-,267,395,233,1011,50,327,2283,234,419,384,3733,73,1139,5982,32929
2016,Argentina,ARG,-,-,0,0,0,11,0,13,24,0,0,0,13,5,0,18,339
2016,Armenia,ARM,-,-,454,476,324,3258,431,2262,7205,530,636,479,3407,346,2207,7605,23811
2016,Australia,AUS,-,-,0,0,0,0,0,0,0,0,5,0,0,0,0,5,25
2016,Austria,AUT,-,-,0,0,0,0,0,0,0,0,0,0,0,0,0,0,5
2016,Azerbaijan,AZE,-,-,462,520,244,2945,498,1652,6321,527,671,334,3371,313,1604,6820,631345
2016,Bahrain,BHR,-,-,5,20,10,14,0,0,49,0,6,5,97,0,5,113,579
2016,Barbados,BRB,-,-,0,0,0,17,0,0,17,0,0,0,18,0,0,18,188
2016,Burundi,BDI,-,-,38445,55763,47623,137261,10143,1804,291039,39159,56675,49234,143345,9373,2897,300683,737748
2016,Belgium,BEL,-,-,0,0,5,5,0,0,10,0,0,0,0,0,5,5,64
2016,Benin,BEN,-,-,12,0,13,78,0,70,173,7,5,45,502,0,125,684,1630
2016,Bangladesh,BGD,-,-,52,35,14,313,0,733,1147,52,43,66,4431,29,6804,11425,39786
2016,Bahamas,BHS,-,-,0,0,0,31,0,0,31,0,0,0,44,0,0,44,417
2016,Bhutan,BTN,-,-,476,793,681,2935,444,17,5346,509,853,651,3336,611,121,6081,12034
2016,Burkina Faso,BFA,-,-,7,15,5,54,0,128,209,5,15,17,415,0,143,595,6547
2016,Belarus,BLR,-,-,39,38,23,240,8,282,630,33,51,31,284,17,360,776,5816
2016,Bolivia (Plurinational State of),BOL,-,-,8,18,12,41,5,37,121,0,20,0,80,8,38,146,941
2016,Botswana,BWA,-,-,0,6,0,11,0,0,17,0,0,0,16,0,0,16,392
2016,Brazil,BRA,-,-,0,5,13,43,0,7,68,0,0,19,62,0,10,91,4563
2016,Brunei Darussalam,BRN,-,-,0,0,0,0,0,0,0,0,0,0,0,0,0,0,5
2016,Bosnia and Herzegovina,BIH,-,-,205,355,383,3898,2179,76726,83746,243,356,444,4014,1325,79885,86267,172063
2016,Bulgaria,BGR,-,-,5,5,0,17,13,39,79,7,5,0,19,41,53,125,1057
2016,Belize,BLZ,-,-,0,0,0,0,0,0,0,0,0,0,5,0,0,5,218
2016,Cambodia,KHM,-,-,15,9,16,134,0,5890,6064,18,19,17,145,10,6012,6221,12808
2016,Canada,CAN,-,-,0,8,0,5,0,0,13,0,5,0,5,0,0,10,130
2016,Central African Rep.,CAF,-,-,40180,65772,39377,120598,7786,1110,274823,40286,64940,38965,92910,7650,1248,245999,934277
2016,Cayman Islands,CYM,-,-,0,0,0,0,0,0,0,0,0,0,0,0,0,0,6
2016,Chad,TCD,-,-,15415,18108,11956,34973,4469,412,85333,16904,17081,10833,21822,2555,985,70180,158414
2016,China,CHN,-,-,179,207,134,3096,114,2928,6658,200,176,153,4129,127,4308,9093,279933
2016,Chile,CHL,-,-,0,0,5,71,36,63,175,0,0,0,77,76,70,223,695
2016,Cameroon,CMR,-,-,25388,23355,18233,31656,4066,851,103549,23710,22719,20751,29573,4929,1634,103316,220203
2016,Congo,COG,-,-,1114,1389,2029,5122,789,4380,14823,957,1238,1439,3420,500,5170,12724,33039
2016,Dem. Rep. of the Congo,COD,-,-,267845,366107,185876,568632,53479,22294,1464233,271953,368340,194282,475133,33909,27566,1371183,2862556
2016,Comoros,COM,-,-,0,7,0,0,0,197,204,0,5,0,6,0,355,366,798
2016,Colombia,COL,-,-,119,312,537,2036,141,3636386,3639531,113,299,506,3205,187,3785581,3789891,7734456
2016,Costa Rica,CRI,-,-,0,0,5,0,0,0,5,0,0,0,0,0,5,5,514
2016,Cuba,CUB,-,-,9,10,43,702,47,991,1802,12,31,48,1369,46,1793,3299,10965
2016,Cabo Verde,CPV,-,-,0,0,0,0,0,29,29,0,5,0,0,0,52,57,108
2016,Cyprus,CYP,-,-,0,0,0,0,0,0,0,0,0,0,0,0,0,0,5
2016,Czechia,CZE,-,-,0,5,5,136,180,19,345,0,6,0,209,346,22,583,1499
2016,Denmark,DNK,-,-,0,0,0,0,0,0,0,0,0,0,0,0,0,0,5
2016,Djibouti,DJI,-,-,0,10,14,131,0,270,425,5,19,17,165,0,203,409,2268
2016,Dominica,DMA,-,-,0,0,0,0,0,0,0,0,0,0,0,0,0,0,146
2016,Dominican Rep.,DOM,-,-,0,0,12,77,7,286,382,0,0,5,84,0,611,700,2713
2016,Ecuador,ECU,-,-,0,22,18,32,0,18,90,0,12,0,53,0,38,103,14723
2016,Equatorial Guinea,GNQ,-,-,0,0,0,11,0,15,26,0,0,0,26,10,14,50,231
2016,Eritrea,ERI,-,-,10099,19823,16711,73370,4611,9911,134525,10569,21105,22512,98349,5815,14918,173268,525014
2016,Estonia,EST,-,-,0,0,0,0,0,8,8,0,0,0,0,0,0,0,345
2016,Ethiopia,ETH,-,-,5810,8131,5854,32070,834,5350,58049,6238,8379,6974,36004,954,17804,76353,163502
2016,Fiji,FJI,-,-,0,0,0,0,0,0,0,0,0,0,0,0,0,0,1301
2016,Finland,FIN,-,-,0,0,0,0,0,0,0,0,0,0,0,0,0,0,10
2016,France,FRA,-,-,0,0,0,0,0,8,8,0,5,0,22,5,6,38,166
2016,Gabon,GAB,-,-,0,0,0,27,0,33,60,0,0,5,26,0,44,75,598
2016,Gambia,GMB,-,-,88,59,30,443,0,166,786,80,43,372,9532,6,372,10405,30477
2016,Palestinian,PSE,-,-,6920,9511,6099,19018,1753,334,43635,7670,6121,11176,21277,1601,1228,49073,105973
2016,United Kingdom of Great Britain and Northern Ireland,GBR,-,-,0,0,0,5,0,0,5,0,0,7,8,0,0,15,178
2016,Georgia,GEO,-,-,11641,13809,12175,78036,32882,1608,150151,12228,14930,13434,69964,21021,1568,133145,294317
2016,Germany,DEU,-,-,0,5,0,0,0,7,12,0,0,0,0,0,5,5,195
2016,Ghana,GHA,-,-,1337,1461,574,2935,296,1058,7661,1300,1578,632,3593,152,1583,8838,27373
2016,Guinea-Bissau,GNB,-,-,6,21,12,76,0,400,515,0,5,36,552,5,881,1479,3516
2016,Greece,GRC,-,-,0,0,6,0,7,0,13,0,8,0,12,26,0,46,177
2016,Grenada,GRD,-,-,0,0,0,7,0,0,7,0,0,0,0,0,0,0,163
2016,Guatemala,GTM,-,-,0,0,0,38,0,16,54,0,0,10,43,0,37,90,58771
2016,Guinea,GIN,-,-,186,107,92,834,10,5783,7012,159,97,650,4881,7,4187,9981,41925
2016,Guyana,GUY,-,-,0,0,0,6,0,5,11,0,0,0,17,0,20,37,565
2016,Haiti,HTI,-,-,6,120,128,7176,51,1569,9050,14,122,116,24410,74,1965,26701,75055
2016,"China, Hong Kong SAR",HKG,-,-,5,0,0,5,0,0,10,5,0,0,14,0,0,19,127
2016,Honduras,HND,-,-,10005,12700,13739,48703,4300,1021,90468,11100,15912,12536,41752,3600,4062,88962,224507
2016,Croatia,HRV,-,-,0,143,739,7806,5528,52,14268,5,135,682,8047,2830,39,11738,41092
2016,Hungary,HUN,-,-,11,0,0,159,68,31,269,12,5,10,301,151,91,570,4575
2016,Iceland,ISL,-,-,0,0,0,0,0,0,0,0,0,0,0,0,0,0,5
2016,Cote d'Ivoire,CIV,-,-,2325,3896,2491,9132,521,1602,19967,2364,3909,2559,11079,409,1673,21993,65456
2016,India,IND,-,-,94,102,53,1028,14,344,1635,125,113,101,3420,29,1588,5376,35491
2016,Indonesia,IDN,-,-,62,18,21,421,5,5,532,70,27,20,192,14,0,323,16637
2016,Ireland,IRL,-,-,0,0,0,0,0,0,0,0,0,0,0,0,0,0,42
2016,Iran (Islamic Rep. of),IRN,-,-,1940,3481,2718,28542,1885,2197,40763,2060,3050,3712,51981,2455,4866,68124,181910
2016,Iraq,IRQ,-,-,18963,31132,20092,99500,10013,5188,184888,20213,33886,25793,150966,9471,8568,248897,4214486
2016,Israel,ISR,-,-,0,7,5,27,5,15,59,0,0,15,59,0,18,92,1035
2016,Italy,ITA,-,-,0,9,0,15,0,6,30,5,7,0,8,0,5,25,181
2016,Jamaica,JAM,-,-,0,7,0,79,0,5,91,5,5,0,139,0,14,163,3132
2016,Jordan,JOR,-,-,34,89,14,453,15,66,671,21,33,61,360,6,87,568,4483
2016,Japan,JPN,-,-,0,11,5,5,0,0,21,0,6,5,5,0,0,16,136
2016,Kazakhstan,KAZ,-,-,20,40,12,214,38,317,641,23,43,23,478,5,262,834,4591
2016,Kenya,KEN,-,-,354,422,388,1295,170,209,2838,413,476,367,941,130,225,2552,11102
2016,Kyrgyzstan,KGZ,-,-,36,55,40,246,16,187,580,38,75,42,272,5,201,633,4939
2016,Rep. of Korea,KOR,-,-,0,6,6,25,0,0,37,5,0,10,36,0,14,65,509
2016,Dem. People's Rep. of Korea,PRK,-,-,11,6,0,80,11,25,133,5,5,5,112,5,23,155,1945
2016,Kuwait,KWT,-,-,5,0,32,31,0,54,122,0,8,8,67,0,136,219,1663
2016,Lao People's Dem. Rep.,LAO,-,-,0,0,0,0,9,3301,3310,0,0,0,40,6,3686,3732,7396
2016,Liberia,LBR,-,-,184,224,293,1476,54,106,2337,144,234,284,2044,42,229,2977,9268
2016,Libya,LBY,-,-,152,203,113,635,5,194,1302,163,251,159,1995,26,419,3013,189872
2016,Saint Lucia,LCA,-,-,0,0,9,7,0,0,16,0,0,6,23,0,0,29,1189
2016,Lebanon,LBN,-,-,268,291,213,1384,103,313,2572,299,409,283,3009,59,953,5012,13203
2016,Lesotho,LSO,-,-,0,0,0,5,0,148,153,0,0,0,0,0,68,68,703
2016,Sri Lanka,LKA,-,-,440,343,222,2374,406,41140,44925,415,365,319,7313,285,50677,59374,172676
2016,Lithuania,LTU,-,-,0,0,0,5,0,0,5,0,0,0,0,0,19,19,152
2016,Latvia,LVA,-,-,0,5,0,0,0,19,24,0,0,0,19,0,19,38,261
2016,"China, Macao SAR",MAC,-,-,0,0,0,0,0,0,0,0,0,0,0,0,0,0,5
2016,Madagascar,MDG,-,-,0,5,0,16,0,111,132,0,0,0,5,0,114,119,350
2016,Mauritania,MRT,-,-,2673,3698,2093,5769,464,1271,15968,2767,3755,2058,5593,569,4135,18877,43654
2016,North Macedonia,MKD,-,-,467,517,428,1825,65,231,3533,521,601,433,1861,86,261,3763,8784
2016,Monaco,MCO,-,-,0,0,0,0,0,0,0,0,0,0,0,0,0,0,5
2016,Rep. of Moldova,MDA,-,-,165,196,103,699,28,172,1363,185,198,125,563,25,182,1278,6670
2016,Maldives,MDV,-,-,0,5,0,0,0,0,5,0,0,0,8,0,0,8,93
2016,Mexico,MEX,-,-,0,0,11,68,0,20,99,0,0,11,97,0,38,146,74643
2016,Marshall Islands,MHL,-,-,0,0,0,0,0,0,0,0,0,0,0,0,0,0,5
2016,Mali,MLI,-,-,9840,15493,18603,27838,2932,3394,78100,10036,15216,13458,25427,2788,1220,68145,202830
2016,Malaysia,MYS,-,-,5,7,7,11,0,12,42,0,0,9,10,0,0,19,6616
2016,Malawi,MWI,-,-,13,15,5,92,0,894,1019,9,10,5,93,0,2502,2619,4179
2016,Mongolia,MNG,-,-,140,76,31,479,18,249,993,123,109,38,413,9,165,857,6113
2016,Morocco,MAR,-,-,61,33,27,622,7,162,912,61,29,124,2255,7,570,3046,9500
2016,Mozambique,MOZ,-,-,467,533,265,809,63,707,2844,468,532,303,714,56,800,2873,20878
2016,Montenegro,MNE,-,-,95,95,75,346,24,67,702,93,104,74,308,16,64,659,1845
2016,Mauritius,MUS,-,-,5,0,7,21,0,5,38,0,0,5,18,0,5,28,309
2016,Myanmar,MMR,-,-,31359,29274,26402,98945,8321,56,194357,31823,30681,28140,139986,7266,303,238199,921585
2016,Namibia,NAM,-,-,33,76,50,138,0,5,302,33,82,46,511,30,16,718,1534
2016,Nepal,NPL,-,-,5,0,7,721,12,90,835,9,0,22,502,0,238,771,20480
2016,Netherlands (Kingdom of the),NLD,-,-,0,0,0,9,0,0,9,5,0,0,5,0,0,10,74
2016,Niger,NER,-,-,13181,17918,7179,27171,1976,55,67480,15088,20192,7802,23015,3321,102,69520,138137
2016,Nicaragua,NIC,-,-,18,15,18,283,24,205,563,25,14,21,612,12,302,986,3534
2016,Nigeria,NGA,-,-,20530,24185,10357,42278,2771,1802,101923,21800,25157,11077,40930,4407,5824,109195,2515440
2016,Niue,NIU,-,-,0,0,0,0,0,0,0,0,0,0,0,0,0,0,19
2016,Norway,NOR,-,-,0,0,0,0,0,0,0,0,0,0,0,0,0,0,25
2016,New Zealand,NZL,-,-,0,0,0,0,0,0,0,0,0,0,8,0,0,8,43
2016,Oman,OMN,-,-,0,0,0,5,0,0,5,0,0,5,0,0,0,5,59
2016,Pakistan,PAK,-,-,42370,62118,25278,106355,10000,455,246576,51614,72832,37165,132634,10533,4683,309461,622075
2016,Panama,PAN,-,-,0,0,0,0,0,5,5,0,0,0,0,0,0,0,114
2016,Paraguay,PRY,-,-,5,0,0,18,0,6,29,0,0,0,13,0,23,36,185
2016,Peru,PER,-,-,0,0,5,295,65,141,506,0,5,13,321,68,189,596,4889
2016,Philippines,PHL,-,-,10,10,11,243,5,43783,44062,0,5,12,187,0,43721,43925,171016
2016,Papua New Guinea,PNG,-,-,0,0,0,0,0,0,0,0,0,0,0,0,0,0,662
2016,Poland,POL,-,-,8,0,7,78,109,123,325,0,0,12,185,317,184,698,1724
2016,Portugal,PRT,-,-,0,0,0,0,0,10,10,5,0,0,6,5,12,28,101
2016,Qatar,QAT,-,-,0,0,0,0,0,0,0,0,0,0,0,0,0,0,48
2016,Romania,ROU,-,-,5,0,11,103,34,93,246,0,5,7,113,90,122,337,3715
2016,South Africa,ZAF,-,-,11,19,18,127,0,65,240,13,22,10,162,8,292,507,1534
2016,Russian Federation,RUS,-,-,1977,2686,1332,6922,492,9492,22901,2170,2878,1525,6687,301,8915,22476,98125
2016,Rwanda,RWA,-,-,29571,37806,26169,51345,2754,2614,150259,26120,38766,27472,50626,3551,2600,149135,303758
2016,El Salvador,SLV,-,-,39,71,129,602,62,4185,5088,49,69,182,719,74,7076,8169,91580
2016,Saudi Arabia,SAU,-,-,20,27,7,93,0,13,160,11,36,0,89,0,11,147,1933
2016,Serbia and Kosovo: S/RES/1244 (1999),SRB,-,-,2385,10619,14037,73715,23987,6881,131624,2529,11216,14981,76574,19755,7614,132669,278260
2016,Senegal,SEN,-,-,1059,1831,1112,4131,543,927,9603,1019,1889,1174,6243,520,5901,16746,39355
2016,Seychelles,SYC,-,-,0,0,0,0,0,0,0,0,0,0,0,0,0,0,15
2016,Singapore,SGP,-,-,0,0,0,0,0,0,0,0,5,0,0,0,0,5,85
2016,Sierra Leone,SLE,-,-,89,87,100,651,5,247,1179,50,83,143,1947,20,2006,4249,10831
2016,Solomon Islands,SLB,-,-,0,0,0,0,0,0,0,0,5,0,0,0,0,5,150
2016,Somalia,SOM,-,-,243525,283658,146618,461213,38587,8103,1181704,305944,330505,183689,467720,35858,28881,1352597,2635655
2016,Spain,ESP,-,-,5,11,0,10,0,11,37,0,8,5,5,8,15,41,154
2016,Viet Nam,VNM,-,-,76,95,70,810,180,4039,5270,108,91,109,1373,199,5080,6960,333947
2016,Saint Kitts and Nevis,KNA,-,-,0,0,0,0,0,0,0,0,0,0,0,0,0,0,71
2016,Sao Tome and Principe,STP,-,-,0,5,0,10,0,8,23,0,5,0,6,0,5,16,39
2016,Sudan,SDN,-,-,58533,80621,50878,143338,11939,833,346142,60490,81370,50121,111932,9626,6807,320346,2926542
2016,Suriname,SUR,-,-,0,0,0,0,0,0,0,0,0,0,0,0,5,5,41
2016,South Sudan,SSD,-,-,95770,140715,86487,198217,15694,1078268,1615151,97441,146243,96456,118332,6024,1013041,1477537,3296423
2016,Slovakia,SVK,-,-,0,0,0,40,17,59,116,0,0,0,152,34,56,242,1372
2016,Slovenia,SVN,-,-,0,0,0,0,0,0,0,0,0,0,0,7,0,7,32
2016,Eswatini,SWZ,-,-,0,0,0,11,0,0,11,0,0,0,9,0,5,14,361
2016,Sweden,SWE,-,-,0,0,0,5,0,0,5,0,0,0,0,0,0,0,30
2016,Switzerland,CHE,-,-,0,0,0,0,0,0,0,0,0,0,0,0,0,0,15
2016,Syrian Arab Rep.,SYR,-,-,166460,230191,133946,527722,36580,9878,1104777,175472,245732,156112,608570,29826,16539,1232251,12043342
2016,United Rep. of Tanzania,TZA,-,-,20,20,16,103,0,103,262,17,28,9,206,0,551,811,1804
2016,Turks and Caicos Islands,TCA,-,-,0,0,0,0,0,0,0,0,0,0,0,0,0,0,19
2016,Thailand,THA,-,-,0,5,5,120,0,0,130,0,10,5,33,5,29,82,1097
2016,Tajikistan,TJK,-,-,190,197,71,546,14,35,1053,195,182,129,1109,10,37,1662,4130
2016,Turkmenistan,TKM,-,-,35,49,13,481,14,17,609,44,43,19,239,8,20,373,1440
2016,Timor-Leste,TLS,-,-,0,0,0,0,0,0,0,0,0,0,0,0,0,0,19
2016,Togo,TGO,-,-,156,341,288,1375,82,676,2918,157,362,257,2769,119,1115,4779,10941
2016,Tonga,TON,-,-,0,0,0,0,0,0,0,0,0,0,0,0,0,0,102
2016,Trinidad and Tobago,TTO,-,-,0,0,0,5,0,0,5,6,0,0,10,0,0,16,542
2016,Tunisia,TUN,-,-,28,29,21,223,0,204,505,37,15,50,822,5,441,1370,3756
2016,Türkiye,TUR,-,-,857,1929,2121,13540,2538,4227,25212,1002,771,2414,21423,2227,11325,39162,81196
2016,United Arab Emirates,ARE,-,-,0,5,5,5,0,0,15,5,13,0,7,0,0,25,263
2016,Uganda,UGA,-,-,18142,18205,18129,19300,18023,466,92265,18149,18185,18150,19373,18042,1121,93020,191557
2016,Ukraine,UKR,-,-,401,520,287,2762,352,911,5233,476,559,327,2646,151,786,4945,2073705
2016,Uruguay,URY,-,-,5,0,0,0,0,6,11,0,0,0,0,0,0,0,126
2016,United States of America,USA,-,-,15,26,47,34,6,10,138,10,33,36,53,10,14,156,595
2016,Uzbekistan,UZB,-,-,45,70,54,491,17,190,867,41,61,95,324,5,172,698,6911
2016,Saint Vincent and the Grenadines,VCT,-,-,0,7,15,23,0,0,45,0,6,6,23,0,0,35,1466
2016,Venezuela (Bolivarian Republic of),VEN,-,-,56,59,71,472,5,1988,2651,64,84,37,756,16,3885,4842,52617
2016,Samoa,WSM,-,-,0,0,0,0,0,0,0,0,0,0,0,0,0,0,10
2016,Western Sahara,ESH,-,-,0,0,0,23,0,44119,44142,0,0,0,151,0,46309,46460,118641
2016,Yemen,YEM,-,-,81536,273525,172361,458977,30655,154,1017208,82718,287697,205558,419956,41352,239,1037520,2059362
2016,Zambia,ZMB,-,-,0,0,0,10,0,163,173,0,0,0,10,0,84,94,550
2016,Zimbabwe,ZWE,-,-,96,133,73,672,13,19612,20599,96,113,81,677,17,15639,16623,61493
2016,Stateless,XXA,-,-,368,611,422,2213,126,522,4262,390,765,666,5164,218,814,8017,59432
2016,Tibetan,TIB,-,-,0,0,0,7003,0,0,7003,0,0,0,6511,0,5,6516,13546
2016,Curacao ,CUW,-,-,0,0,0,0,0,0,0,0,0,0,0,0,0,0,35
2016,Unknown ,UNK,-,-,2066,2633,1858,8919,725,14621,30822,2242,3027,3000,19957,1255,30574,60055,396467
2017,Afghanistan,AFG,-,-,343402,395696,306373,789832,73335,3213,1911851,352084,426375,345197,974417,96488,17075,2211636,5243370
2017,Albania,ALB,-,-,414,469,325,1834,44,2247,5333,472,516,480,2060,57,2154,5739,30929
2017,Algeria,DZA,-,-,84,57,44,452,8,782,1427,82,94,77,2354,33,1149,3789,10460
2017,Andorra,AND,-,-,0,0,0,0,0,0,0,0,0,0,0,0,0,0,5
2017,Angola,AGO,-,-,1613,2349,1447,4813,490,1533,12245,1561,2245,1532,4083,843,2001,12265,33840
2017,Antigua and Barbuda,ATG,-,-,0,0,0,0,0,0,0,0,0,0,0,0,0,0,162
2017,Egypt,EGY,-,-,327,484,297,1217,39,309,2673,298,479,361,3715,74,798,5725,36735
2017,Argentina,ARG,-,-,0,0,0,6,0,10,16,0,0,0,0,8,0,8,473
2017,Armenia,ARM,-,-,541,588,397,3577,501,2246,7850,604,743,599,3646,389,2150,8131,25701
2017,Australia,AUS,-,-,0,0,0,0,0,0,0,0,0,5,0,0,0,5,20
2017,Austria,AUT,-,-,0,5,0,0,0,0,5,0,0,0,0,0,0,0,36
2017,Azerbaijan,AZE,-,-,567,679,310,3293,526,1635,7010,664,819,457,3672,324,1579,7515,633219
2017,Bahrain,BHR,-,-,5,15,17,22,0,0,59,5,5,5,109,0,11,135,669
2017,Barbados,BRB,-,-,0,0,0,0,0,0,0,0,0,0,0,0,0,0,248
2017,Burundi,BDI,-,-,44478,63495,48381,153881,42902,3632,356769,43912,63332,48762,159353,10297,32772,358428,721216
2017,Belgium,BEL,-,-,0,0,0,6,0,0,6,0,0,0,0,0,0,0,89
2017,Benin,BEN,-,-,20,0,0,86,0,26,132,11,5,26,267,0,18,327,1709
2017,Bangladesh,BGD,-,-,70,60,20,275,5,989,1419,56,51,45,3742,18,30918,34830,84913
2017,Bahamas,BHS,-,-,0,0,0,0,0,0,0,0,0,0,0,0,0,0,613
2017,Bhutan,BTN,-,-,266,502,415,1898,345,18,3444,312,547,415,2290,478,99,4141,8354
2017,Burkina Faso,BFA,-,-,284,341,154,562,17,113,1471,254,304,181,611,22,90,1462,10601
2017,Belarus,BLR,-,-,25,45,18,218,12,289,607,28,50,32,210,18,331,669,6512
2017,Bolivia (Plurinational State of),BOL,-,-,0,0,12,19,0,17,48,0,0,0,24,8,19,51,1385
2017,Botswana,BWA,-,-,0,0,0,18,0,0,18,0,5,0,0,0,0,5,374
2017,Brazil,BRA,-,-,0,23,15,31,0,12,81,0,0,22,60,0,5,87,7637
2017,Brunei Darussalam,BRN,-,-,0,0,0,0,0,0,0,0,0,0,0,0,0,0,9
2017,Bosnia and Herzegovina,BIH,-,-,103,194,296,3441,2107,75012,81153,104,245,349,3613,1289,78145,83745,167057
2017,Bulgaria,BGR,-,-,7,0,6,23,13,27,76,0,13,0,14,38,49,114,1032
2017,Belize,BLZ,-,-,0,0,0,0,0,0,0,0,0,0,0,0,0,0,270
2017,Cambodia,KHM,-,-,14,24,24,151,5,5823,6041,12,20,29,164,10,5860,6095,13816
2017,Canada,CAN,-,-,0,8,0,5,0,5,18,5,5,6,5,0,0,21,153
2017,Central African Rep.,CAF,-,-,55518,68973,49485,120425,8635,1269,304305,55834,68287,44476,96047,7843,1463,273950,1268642
2017,Cayman Islands,CYM,-,-,0,0,0,0,0,0,0,0,0,0,0,0,0,0,6
2017,Chad,TCD,-,-,13819,18410,8125,28333,2470,11414,82571,13698,18316,8314,17420,2133,11589,71470,156730
2017,China,CHN,-,-,189,178,122,2518,86,2452,5545,230,200,108,3609,117,3078,7342,297224
2017,Chile,CHL,-,-,0,6,0,62,38,46,152,0,0,0,46,75,33,154,843
2017,Cameroon,CMR,-,-,810,711,2257,2102,344,109810,116034,800,487,1609,3942,171,115155,122164,257358
2017,Congo,COG,-,-,125,140,153,649,13,76507,77587,99,195,155,1003,56,48894,50402,134281
2017,Dem. Rep. of the Congo,COD,-,-,522233,659023,366971,978617,131665,35922,2694431,524957,509462,379062,822296,102044,58243,2396064,5118888
2017,Comoros,COM,-,-,0,0,7,0,0,207,214,0,5,0,6,0,368,379,922
2017,Colombia,COL,-,-,443,1368,2242,13804,1024,4072494,4091375,436,1400,2319,15168,1315,3612632,3633270,7901722
2017,Costa Rica,CRI,-,-,0,0,5,0,0,0,5,0,0,0,0,0,0,0,681
2017,Cuba,CUB,-,-,28,26,70,1469,59,328,1980,25,47,52,3415,72,633,4244,18589
2017,Cabo Verde,CPV,-,-,0,0,0,0,0,0,0,0,0,0,0,0,0,0,186
2017,Cyprus,CYP,-,-,0,0,0,0,0,0,0,0,0,0,0,0,0,0,20
2017,Czechia,CZE,-,-,0,0,0,93,195,11,299,0,0,0,143,346,23,512,1579
2017,Denmark,DNK,-,-,0,0,0,0,0,0,0,0,0,0,0,0,0,0,21
2017,Djibouti,DJI,-,-,5,18,13,48,10,169,263,0,14,8,69,0,101,192,3047
2017,Dominica,DMA,-,-,0,0,0,0,0,0,0,0,0,0,0,0,0,0,89
2017,Dominican Rep.,DOM,-,-,0,5,5,173,6,39,228,0,0,0,102,0,10,112,3586
2017,Ecuador,ECU,-,-,0,21,19,19,0,12,71,5,6,0,28,0,23,62,18592
2017,Equatorial Guinea,GNQ,-,-,0,0,0,10,0,17,27,0,0,0,20,5,15,40,237
2017,Eritrea,ERI,-,-,13841,22211,27439,88130,5031,14632,171284,14263,23403,30907,156059,6273,15755,246660,564662
2017,Estonia,EST,-,-,0,0,0,0,0,7,7,0,0,5,0,0,0,5,330
2017,Ethiopia,ETH,-,-,6456,9091,6521,35693,1078,8712,67551,6840,9576,7674,40888,1396,60231,126605,1303794
2017,French Guiana,GUF,-,-,0,0,0,0,0,0,0,0,0,0,0,0,0,0,11
2017,Fiji,FJI,-,-,0,0,0,0,0,0,0,0,0,0,0,0,0,0,1412
2017,Finland,FIN,-,-,0,0,0,0,0,0,0,0,0,0,0,0,0,0,15
2017,France,FRA,-,-,0,0,0,0,0,0,0,0,5,0,14,6,0,25,194
2017,Gabon,GAB,-,-,5,0,0,15,0,41,61,0,9,0,36,0,41,86,912
2017,Gambia,GMB,-,-,106,47,38,492,0,178,861,92,56,221,8930,6,181,9486,36778
2017,Palestinian,PSE,-,-,6827,9523,6215,19115,1851,331,43862,7521,6682,11259,21205,1768,599,49034,110150
2017,United Kingdom of Great Britain and Northern Ireland,GBR,-,-,0,0,0,6,0,0,6,6,0,5,6,0,0,17,243
2017,Georgia,GEO,-,-,11722,16383,10516,80240,31892,1628,152381,12219,17618,11710,71731,20152,1599,135029,301104
2017,Germany,DEU,-,-,0,0,0,0,0,11,11,0,0,0,0,0,0,0,245
2017,Ghana,GHA,-,-,1322,1471,573,2811,295,1535,8007,1255,1573,608,2779,161,1682,8058,34463
2017,Guinea-Bissau,GNB,-,-,11,11,18,81,0,304,425,12,0,27,415,5,875,1334,5372
2017,Greece,GRC,-,-,0,0,0,6,0,0,6,0,0,0,13,29,0,42,201
2017,Grenada,GRD,-,-,0,0,0,0,0,0,0,0,0,0,0,0,0,0,165
2017,Guatemala,GTM,-,-,0,0,5,11,0,24,40,0,0,6,39,0,35,80,89010
2017,Guinea,GIN,-,-,225,158,79,952,6,4656,6076,205,109,856,6272,16,12548,20006,54851
2017,Guyana,GUY,-,-,0,0,0,5,0,5,10,0,0,0,5,0,11,16,742
2017,Haiti,HTI,-,-,11,104,112,628,37,1609,2501,21,110,103,748,60,1972,3014,109313
2017,"China, Hong Kong SAR",HKG,-,-,0,0,0,0,0,0,0,0,0,0,0,0,0,0,115
2017,Honduras,HND,-,-,10005,12708,13721,48694,4300,696,90124,11100,15900,12528,41696,3600,2994,87818,251406
2017,Croatia,HRV,-,-,0,131,693,7410,5230,41,13505,0,121,638,7610,2675,44,11088,33156
2017,Hungary,HUN,-,-,0,0,0,25,68,32,125,0,5,0,41,137,40,223,4997
2017,Iceland,ISL,-,-,0,0,0,5,0,0,5,0,0,0,0,0,0,0,5
2017,Cote d'Ivoire,CIV,-,-,1736,2705,1963,7462,408,1836,16110,1777,2739,2056,9787,311,8025,24695,66564
2017,India,IND,-,-,89,81,50,726,12,809,1767,80,88,98,2071,19,3901,6257,48517
2017,Indonesia,IDN,-,-,9,0,5,59,0,11,84,0,5,5,0,7,5,22,17869
2017,Ireland,IRL,-,-,0,0,0,0,0,0,0,0,0,0,0,0,0,0,52
2017,Iran (Islamic Rep. of),IRN,-,-,2275,3828,3026,31124,1980,1853,44086,2353,4203,3756,54479,2898,2593,70282,196447
2017,Iraq,IRQ,-,-,22103,37786,24152,112873,11656,5267,213837,23332,41131,29265,162680,11137,6613,274158,3262378
2017,Israel,ISR,-,-,0,12,0,21,5,12,50,0,0,17,26,0,5,48,1160
2017,Italy,ITA,-,-,12,11,0,10,0,0,33,0,6,5,11,0,5,27,334
2017,Jamaica,JAM,-,-,0,0,0,26,0,5,31,0,0,0,134,0,9,143,3654
2017,Jordan,JOR,-,-,40,62,28,439,14,28,611,43,50,81,351,9,53,587,5646
2017,Japan,JPN,-,-,0,7,5,5,0,0,17,0,6,0,5,0,0,11,143
2017,Kazakhstan,KAZ,-,-,23,37,16,400,35,309,820,35,33,42,981,5,255,1351,5920
2017,Kenya,KEN,-,-,431,406,364,1318,170,624,3313,499,436,333,908,126,758,3060,13293
2017,Kyrgyzstan,KGZ,-,-,48,56,48,232,16,159,559,33,109,31,286,0,177,636,5341
2017,Rep. of Korea,KOR,-,-,0,0,6,20,0,0,26,0,0,9,23,0,0,32,620
2017,Dem. People's Rep. of Korea,PRK,-,-,7,5,5,57,5,0,79,5,0,8,78,7,0,98,1763
2017,Kuwait,KWT,-,-,10,28,36,77,0,5,156,8,46,31,81,0,72,238,2053
2017,Lao People's Dem. Rep.,LAO,-,-,0,0,0,0,8,3256,3264,0,0,0,42,6,3592,3640,7279
2017,Liberia,LBR,-,-,171,207,332,1417,57,102,2286,163,262,278,1911,41,848,3503,9546
2017,Libya,LBY,-,-,216,274,137,766,9,291,1693,202,322,149,2080,31,565,3349,198989
2017,Saint Lucia,LCA,-,-,0,0,0,0,0,0,0,0,0,0,0,0,0,0,1173
2017,Lebanon,LBN,-,-,314,388,264,1441,107,52,2566,329,429,314,2276,61,136,3545,14586
2017,Lesotho,LSO,-,-,0,0,0,0,0,0,0,0,0,0,0,0,0,0,26
2017,Sri Lanka,LKA,-,-,268,334,211,2268,418,41487,44986,233,331,263,7348,304,48687,57166,173894
2017,Lithuania,LTU,-,-,0,0,5,0,0,0,5,0,0,0,0,0,11,11,168
2017,Latvia,LVA,-,-,5,0,0,5,0,19,29,0,0,6,12,0,19,37,267
2017,"China, Macao SAR",MAC,-,-,0,0,0,0,0,0,0,0,0,0,0,0,0,0,10
2017,Madagascar,MDG,-,-,0,0,0,15,0,110,125,0,0,0,0,0,111,111,370
2017,Mauritania,MRT,-,-,2016,3756,2360,5999,568,1258,15957,2099,3855,2290,5846,690,9776,24556,44073
2017,North Macedonia,MKD,-,-,212,321,249,1014,46,173,2015,255,337,250,984,50,186,2062,5691
2017,Monaco,MCO,-,-,0,0,0,0,0,0,0,0,0,0,0,0,0,0,5
2017,Rep. of Moldova,MDA,-,-,44,44,30,225,7,205,555,30,44,35,185,10,194,498,5757
2017,Maldives,MDV,-,-,0,5,0,0,0,0,5,0,0,0,8,5,0,13,98
2017,Mexico,MEX,-,-,0,0,0,31,0,21,52,0,0,6,23,0,18,47,96757
2017,Marshall Islands,MHL,-,-,0,0,0,0,0,0,0,0,0,0,0,0,0,0,7
2017,Mali,MLI,-,-,12707,17872,9628,28612,2391,3670,74880,12781,17868,9611,19014,2364,1091,62729,203929
2017,Malaysia,MYS,-,-,11,5,8,94,0,9,127,8,0,6,376,0,0,390,10018
2017,Malawi,MWI,-,-,19,5,5,90,0,612,731,20,5,5,89,0,2149,2268,3588
2017,Mongolia,MNG,-,-,134,116,40,519,14,251,1074,117,114,40,416,10,176,873,6401
2017,Morocco,MAR,-,-,106,53,40,683,12,154,1048,97,39,102,1653,15,537,2443,9957
2017,Mozambique,MOZ,-,-,470,653,371,896,79,3719,6188,509,659,395,827,98,3823,6311,27757
2017,Malta,MLT,-,-,0,0,0,0,0,0,0,0,0,0,0,0,0,0,5
2017,Montenegro,MNE,-,-,28,53,52,232,23,53,441,53,60,59,196,16,38,422,1474
2017,Mauritius,MUS,-,-,0,5,5,21,0,11,42,0,5,0,25,0,5,35,359
2017,Myanmar,MMR,-,-,106093,117484,79501,287563,22696,57,613394,108889,124145,82418,283302,20273,283,619310,1551047
2017,Namibia,NAM,-,-,30,56,53,126,0,0,265,29,62,62,491,35,0,679,1584
2017,Nepal,NPL,-,-,0,10,0,480,0,94,584,6,0,15,303,0,151,475,21983
2017,Netherlands (Kingdom of the),NLD,-,-,5,0,0,6,0,0,11,10,0,0,5,0,0,15,103
2017,Niger,NER,-,-,14342,24733,8076,27711,3164,98,78124,12144,19276,6183,18564,4809,867,61843,147597
2017,Nicaragua,NIC,-,-,29,17,20,225,24,264,579,28,19,171,289,7,370,884,4189
2017,Nigeria,NGA,-,-,20490,26583,11234,46288,2859,2904,110358,20120,24065,10751,41597,3380,8307,108220,2035005
2017,Niue,NIU,-,-,0,0,0,0,0,0,0,0,0,0,0,0,0,0,24
2017,Norway,NOR,-,-,0,0,0,0,0,0,0,0,5,0,0,0,0,5,40
2017,New Zealand,NZL,-,-,0,0,0,0,0,0,0,0,0,0,8,0,0,8,61
2017,Oman,OMN,-,-,0,0,6,0,0,0,6,9,0,0,0,0,0,9,61
2017,Pakistan,PAK,-,-,21375,33994,12304,49788,4594,602,122657,25216,41659,19741,74492,7037,11077,179222,380153
2017,Panama,PAN,-,-,0,0,0,0,0,5,5,0,0,0,0,0,5,5,162
2017,Paraguay,PRY,-,-,0,0,0,13,0,6,19,0,0,0,10,0,0,10,252
2017,Peru,PER,-,-,5,0,0,311,65,145,526,0,0,24,329,75,176,604,6085
2017,Philippines,PHL,-,-,13,5,5,301,5,159092,159421,5,10,5,124,0,152851,152995,400518
2017,Palau,PLW,-,-,0,0,0,0,0,0,0,0,0,0,0,0,0,0,5
2017,Papua New Guinea,PNG,-,-,0,0,0,0,0,0,0,0,0,0,0,0,0,0,778
2017,Poland,POL,-,-,0,0,5,67,113,70,255,0,0,7,157,317,75,556,1907
2017,Portugal,PRT,-,-,6,5,0,0,0,0,11,0,0,0,0,0,5,5,187
2017,Qatar,QAT,-,-,0,0,0,0,0,0,0,0,0,0,0,0,0,0,70
2017,Romania,ROU,-,-,5,0,5,41,34,71,156,0,5,9,47,85,95,241,4466
2017,South Africa,ZAF,-,-,16,42,16,135,5,9,223,20,34,15,191,12,23,295,2074
2017,Russian Federation,RUS,-,-,1866,2919,1531,7368,545,8688,22917,2084,3175,1714,7054,338,7956,22321,100247
2017,Rwanda,RWA,-,-,26100,33990,23393,47611,2680,2490,136264,22797,34997,24862,47812,3589,2990,137047,278464
2017,El Salvador,SLV,-,-,40,55,101,722,43,40696,41657,61,69,111,800,66,37964,39071,206477
2017,Saudi Arabia,SAU,-,-,27,23,10,105,0,7,172,6,24,15,66,0,10,121,2475
2017,Serbia and Kosovo: S/RES/1244 (1999),SRB,-,-,1650,9678,13232,70666,23727,6718,125671,1765,10259,14093,72796,19519,7315,125747,263506
2017,Senegal,SEN,-,-,919,1969,1327,4476,618,817,10126,886,1864,1415,5099,520,1150,10934,51765
2017,Seychelles,SYC,-,-,0,0,0,0,0,0,0,0,0,0,0,0,0,0,15
2017,Singapore,SGP,-,-,0,0,0,0,0,0,0,0,7,0,0,0,0,7,103
2017,Sierra Leone,SLE,-,-,99,138,199,613,6,220,1275,84,95,254,1890,22,2244,4589,11106
2017,Solomon Islands,SLB,-,-,0,0,0,8,0,0,8,0,0,0,0,0,0,0,163
2017,Somalia,SOM,-,-,229769,388150,193709,585515,93500,8040,1498683,233775,405552,214792,575280,106032,29648,1565079,3161641
2017,Spain,ESP,-,-,0,22,10,0,0,6,38,6,12,5,5,6,0,34,236
2017,Viet Nam,VNM,-,-,62,101,80,615,184,4085,5127,77,99,87,1121,219,4893,6496,341247
2017,Saint Kitts and Nevis,KNA,-,-,0,0,0,0,0,0,0,0,0,0,0,0,0,0,69
2017,Sao Tome and Principe,STP,-,-,0,5,0,10,0,5,20,0,5,0,6,0,0,11,54
2017,Sudan,SDN,-,-,58388,77464,90368,127027,12517,1045,366809,60416,76932,64659,121228,10547,12723,346505,2743788
2017,Suriname,SUR,-,-,0,7,0,0,0,0,7,0,0,0,0,0,0,0,61
2017,South Sudan,SSD,-,-,162041,251757,153685,364739,30760,1009579,1972561,163656,263088,170340,252475,15323,990180,1855062,4360293
2017,Slovakia,SVK,-,-,0,0,0,14,16,59,89,0,0,0,21,34,57,112,1612
2017,Slovenia,SVN,-,-,0,0,0,0,0,0,0,0,0,0,0,7,0,7,31
2017,Eswatini,SWZ,-,-,0,0,0,16,0,0,16,0,0,0,17,0,0,17,271
2017,Sweden,SWE,-,-,6,0,0,0,0,0,6,0,0,0,0,0,0,0,32
2017,Switzerland,CHE,-,-,0,0,0,0,0,0,0,0,0,0,0,0,0,0,15
2017,Syrian Arab Rep.,SYR,-,-,190650,264241,152233,604450,41122,9962,1262658,201410,281579,174037,714775,34196,11038,1417035,12616278
2017,United Rep. of Tanzania,TZA,-,-,22,25,26,95,0,20,188,18,25,9,179,0,30,261,2125
2017,Turks and Caicos Islands,TCA,-,-,0,0,0,0,0,0,0,0,0,0,0,0,0,0,19
2017,Thailand,THA,-,-,5,5,5,249,0,0,264,0,0,0,73,5,6,84,1497
2017,Tajikistan,TJK,-,-,263,281,96,667,13,34,1354,275,269,162,1290,13,60,2069,4986
2017,Turkmenistan,TKM,-,-,27,27,30,513,5,12,614,21,40,9,231,0,19,320,1480
2017,Timor-Leste,TLS,-,-,0,0,0,0,0,0,0,0,0,0,0,0,0,0,18
2017,Togo,TGO,-,-,168,360,277,1403,92,543,2843,159,367,277,2829,133,766,4531,11877
2017,Tonga,TON,-,-,0,0,0,0,0,0,0,0,0,0,0,0,0,0,140
2017,Trinidad and Tobago,TTO,-,-,9,0,0,0,0,0,9,6,0,0,0,0,18,24,628
2017,Tunisia,TUN,-,-,28,34,21,219,6,256,564,30,30,18,613,16,317,1024,4163
2017,Türkiye,TUR,-,-,1270,2299,2266,14981,2568,5093,28477,1396,2383,2521,23846,2299,9032,41477,95194
2017,United Arab Emirates,ARE,-,-,7,0,5,5,0,0,17,0,18,0,29,0,0,47,344
2017,Uganda,UGA,-,-,167,259,192,1204,18,91451,93291,195,214,216,1413,35,93904,95977,196565
2017,Ukraine,UKR,-,-,275,405,224,1925,274,1170919,1174022,321,440,232,1701,115,631021,633830,1977256
2017,Uruguay,URY,-,-,0,0,0,0,0,0,0,0,0,0,0,0,0,0,186
2017,United States of America,USA,-,-,5,11,31,31,7,6,91,5,23,27,46,9,9,119,2512
2017,Uzbekistan,UZB,-,-,26,109,56,429,14,165,799,48,90,94,299,7,162,700,6946
2017,Vanuatu,VUT,-,-,0,0,0,0,0,0,0,0,0,0,0,0,0,0,14
2017,Saint Vincent and the Grenadines,VCT,-,-,0,0,5,0,0,0,5,0,5,0,0,0,0,5,1447
2017,Venezuela (Bolivarian Republic of),VEN,-,-,926,986,573,13042,173,1620,17320,980,999,569,21223,132,2354,26257,502953
2017,Samoa,WSM,-,-,0,0,0,0,0,0,0,0,0,0,0,0,0,0,11
2017,Western Sahara,ESH,-,-,0,0,0,26,0,44152,44178,0,0,0,160,0,46981,47141,118605
2017,Yemen,YEM,-,-,81579,271974,162341,458545,40341,214,1014994,82753,204745,288432,433327,31159,304,1040720,2062256
2017,Zambia,ZMB,-,-,0,5,0,27,0,44,76,0,0,0,5,0,32,37,429
2017,Zimbabwe,ZWE,-,-,115,186,90,882,13,12532,13818,115,200,106,754,11,11372,12558,39349
2017,Stateless,XXA,-,-,450,692,463,2521,135,355,4616,414,852,689,5396,229,248,7828,62242
2017,Tibetan,TIB,-,-,0,0,0,7003,0,0,7003,0,0,0,6514,0,0,6514,13551
2017,Guadeloupe,GLP,-,-,0,0,0,0,0,0,0,0,0,0,0,0,0,0,37
2017,Curacao ,CUW,-,-,0,0,0,0,0,0,0,0,0,0,0,0,0,0,35
2017,Unknown ,UNK,-,-,2427,2443,1624,8514,485,40082,55575,2580,2783,2381,18535,618,80902,107799,357115
2018,Afghanistan,AFG,-,-,359530,443869,332062,871802,85113,2917,2095293,363797,471951,362078,1045452,109334,18033,2370645,5588126
2018,Albania,ALB,-,-,293,287,351,1549,73,2663,5216,334,379,366,1895,50,2496,5520,34583
2018,Algeria,DZA,-,-,102,41,64,458,17,859,1541,89,98,68,1864,41,1017,3177,11639
2018,Angola,AGO,-,-,1477,2388,1539,4934,518,1569,12425,1407,2322,1602,4162,901,2022,12416,35167
2018,Antigua and Barbuda,ATG,-,-,0,5,0,7,0,0,12,0,0,0,5,0,0,5,154
2018,Egypt,EGY,-,-,334,479,440,1453,95,310,3111,364,560,377,4223,97,794,6415,41657
2018,Argentina,ARG,-,-,5,0,0,17,0,5,27,6,5,0,11,8,0,30,601
2018,Armenia,ARM,-,-,521,386,478,3003,586,2147,7121,493,650,516,3249,401,2065,7374,24742
2018,Australia,AUS,-,-,0,0,0,0,0,0,0,0,0,5,0,0,0,5,27
2018,Austria,AUT,-,-,0,5,0,5,0,0,10,0,0,0,0,0,0,0,34
2018,Azerbaijan,AZE,-,-,558,440,606,3321,667,1525,7117,624,844,457,3684,410,1446,7465,640987
2018,Bahrain,BHR,-,-,5,16,33,18,0,0,72,7,6,5,85,0,10,113,676
2018,Barbados,BRB,-,-,0,0,5,6,0,0,11,0,0,0,10,0,0,10,292
2018,Burundi,BDI,-,-,43222,48787,34634,96009,6014,417,229083,43465,49448,34199,110416,5469,503,243500,487267
2018,Belgium,BEL,-,-,0,0,0,5,0,0,5,0,0,0,0,0,0,0,129
2018,Benin,BEN,-,-,14,5,13,96,0,33,161,17,5,13,255,0,28,318,1743
2018,Bangladesh,BGD,-,-,85,83,55,385,5,886,1499,52,74,69,3448,24,4792,8459,79873
2018,Bahamas,BHS,-,-,0,0,0,8,0,0,8,0,0,0,23,0,0,23,812
2018,Bhutan,BTN,-,-,241,435,381,1721,307,21,3106,257,456,404,2021,445,102,3685,7490
2018,Burkina Faso,BFA,-,-,5166,7258,3744,11330,1039,150,28687,5166,7769,4229,9083,1124,91,27462,63426
2018,Belarus,BLR,-,-,27,34,33,195,14,252,555,28,39,11,217,20,290,605,6808
2018,Bolivia (Plurinational State of),BOL,-,-,0,14,5,22,0,18,59,6,0,0,37,0,20,63,1506
2018,Botswana,BWA,-,-,5,0,7,27,0,0,39,0,0,8,10,0,0,18,378
2018,Brazil,BRA,-,-,11,12,19,89,0,13,144,7,7,11,107,0,7,139,9608
2018,Bosnia and Herzegovina,BIH,-,-,76,98,147,2476,3406,2715,8918,83,126,148,2403,1902,2844,7506,164312
2018,Bulgaria,BGR,-,-,0,0,6,24,11,27,68,0,12,0,20,36,48,116,987
2018,Belize,BLZ,-,-,0,0,5,0,0,0,5,0,5,0,0,0,0,5,287
2018,Cambodia,KHM,-,-,14,17,41,238,5,5660,5975,13,36,22,225,11,5840,6147,12888
2018,Canada,CAN,-,-,0,0,13,6,0,0,19,0,0,5,5,0,0,10,160
2018,Central African Rep.,CAF,-,-,52152,77918,44479,142799,9737,328321,655406,52963,76823,44129,112540,8804,315621,610880,1270803
2018,Cayman Islands,CYM,-,-,0,0,0,0,0,0,0,0,0,0,0,0,0,0,6
2018,Chad,TCD,-,-,15941,15409,13681,35742,9210,528,90511,14514,21362,25441,30630,9900,1110,102957,197334
2018,China,CHN,-,-,221,224,142,2924,169,2799,6479,268,225,181,3813,142,3918,8547,306390
2018,Chile,CHL,-,-,0,0,5,58,37,44,144,0,0,0,62,75,37,174,993
2018,Cameroon,CMR,-,-,2849,3713,2268,10995,843,382012,402680,2880,3571,2031,9688,455,287857,306482,732261
2018,Congo,COG,-,-,142,138,194,649,14,1707,2844,118,181,146,888,45,1845,3223,163208
2018,Dem. Rep. of the Congo,COD,-,-,555351,697410,387625,1035727,144823,8055,2828991,557762,512792,398805,864375,113052,8782,2455568,5381452
2018,Comoros,COM,-,-,0,0,0,11,0,210,221,0,5,5,16,0,373,399,1124
2018,Colombia,COL,-,-,5224,7204,8803,15327,1828,4012414,4050800,5659,7832,9521,16758,1925,3804806,3846501,8000730
2018,Costa Rica,CRI,-,-,0,5,5,5,0,5,20,0,0,0,0,0,0,0,755
2018,Cuba,CUB,-,-,72,82,91,2949,53,74,3321,70,82,74,6422,72,132,6852,32085
2018,Cabo Verde,CPV,-,-,0,0,0,0,0,0,0,0,0,0,0,0,0,0,216
2018,Cyprus,CYP,-,-,0,0,0,0,0,0,0,0,0,0,0,0,0,0,27
2018,Czechia,CZE,-,-,0,0,0,94,203,16,313,0,0,6,131,350,16,503,1460
2018,Denmark,DNK,-,-,0,0,0,0,0,0,0,0,0,0,0,0,0,0,35
2018,Djibouti,DJI,-,-,18,32,16,112,10,198,386,0,26,18,111,0,125,280,3224
2018,Dominica,DMA,-,-,0,0,0,0,0,0,0,0,0,0,0,0,0,0,92
2018,Dominican Rep.,DOM,-,-,0,0,5,303,0,44,352,0,5,5,185,0,12,207,3878
2018,Ecuador,ECU,-,-,20,17,13,33,0,12,95,23,23,0,38,0,13,97,19151
2018,Equatorial Guinea,GNQ,-,-,0,13,5,16,0,17,51,0,0,0,17,5,15,37,316
2018,Eritrea,ERI,-,-,13497,23329,18883,105218,6093,11945,178965,14402,24684,26169,172960,7265,17538,263018,585930
2018,Estonia,EST,-,-,0,0,0,0,0,7,7,0,0,5,0,0,0,5,318
2018,Ethiopia,ETH,-,-,6841,9321,6548,38410,1279,1335153,1397552,7137,9957,7055,42188,1628,1282880,1350845,2845514
2018,French Guiana,GUF,-,-,0,0,0,0,0,0,0,0,0,0,0,0,0,0,23
2018,Fiji,FJI,-,-,0,0,0,0,0,0,0,0,0,0,0,0,0,0,1972
2018,Finland,FIN,-,-,0,0,0,0,0,0,0,0,0,0,0,0,0,0,10
2018,France,FRA,-,-,0,0,0,5,0,0,5,0,5,0,5,5,5,20,278
2018,Gabon,GAB,-,-,6,5,0,23,0,97,131,0,8,0,34,0,82,124,1081
2018,Gambia,GMB,-,-,115,58,43,577,0,197,990,95,65,154,7781,8,124,8227,31253
2018,Palestinian,PSE,-,-,478,1502,1161,6074,1029,349,10593,486,1566,1227,6957,1187,591,12014,115648
2018,United Kingdom of Great Britain and Northern Ireland,GBR,-,-,0,6,0,6,0,0,12,0,5,5,9,0,0,19,268
2018,Georgia,GEO,-,-,11571,17061,10914,80549,33101,1697,154893,12083,18445,11804,72719,20874,1569,137494,310371
2018,Germany,DEU,-,-,0,0,0,0,0,5,5,0,0,0,0,0,0,0,237
2018,Ghana,GHA,-,-,1357,1436,612,2826,314,199,6744,1306,1603,606,2556,157,327,6555,30613
2018,Guinea-Bissau,GNB,-,-,22,5,12,77,0,309,425,10,16,15,380,0,598,1019,4893
2018,Greece,GRC,-,-,0,0,0,0,6,0,6,0,0,0,11,32,0,43,235
2018,Grenada,GRD,-,-,0,0,0,0,0,0,0,0,0,0,0,0,0,0,155
2018,Guatemala,GTM,-,-,42,62,55,304,5,5,473,39,71,59,499,9,9,686,106027
2018,Guinea,GIN,-,-,342,188,115,1521,19,5515,7700,304,154,695,7098,18,3804,12073,56538
2018,Guyana,GUY,-,-,0,0,5,0,0,5,10,0,0,0,6,0,12,18,834
2018,Haiti,HTI,-,-,33,35,57,734,44,1619,2522,35,50,24,1097,57,1948,3211,68490
2018,"China, Hong Kong SAR",HKG,-,-,0,0,0,0,0,0,0,0,6,0,0,0,0,6,33
2018,Honduras,HND,-,-,383,626,349,2919,61,90152,94490,452,719,511,4860,67,89059,95668,315803
2018,Croatia,HRV,-,-,0,19,191,5531,7949,42,13732,0,0,263,5377,4376,36,10052,28560
2018,Hungary,HUN,-,-,6,20,29,137,66,20,278,8,11,27,151,147,41,385,4731
2018,Iceland,ISL,-,-,0,0,0,5,0,0,5,0,0,0,0,0,0,0,10
2018,Cote d'Ivoire,CIV,-,-,1419,2284,1738,6950,390,2608,15389,1465,2341,1752,8994,308,1677,16537,61187
2018,India,IND,-,-,102,61,87,817,17,70,1154,97,88,81,2810,28,166,3270,61602
2018,Indonesia,IDN,-,-,10,5,0,950,0,6,971,13,10,9,6,8,7,53,15543
2018,Ireland,IRL,-,-,0,0,0,0,0,0,0,0,0,0,0,0,0,0,59
2018,Iran (Islamic Rep. of),IRN,-,-,2690,4280,3577,34754,2278,1578,49157,2695,4743,4131,58764,2762,2571,75666,217395
2018,Iraq,IRQ,-,-,20395,37465,26335,114076,12258,5055,215584,21179,41595,29456,157593,11335,6270,267428,2439781
2018,Israel,ISR,-,-,0,11,5,37,0,12,65,0,9,10,33,0,0,52,1175
2018,Italy,ITA,-,-,11,6,5,6,0,5,33,9,5,0,10,5,0,29,450
2018,Jamaica,JAM,-,-,0,0,12,74,0,5,91,0,7,5,168,0,11,191,3943
2018,Jordan,JOR,-,-,48,99,53,1797,35,42,2074,50,95,78,430,10,40,703,7980
2018,Japan,JPN,-,-,0,5,5,5,0,0,15,0,0,9,0,0,0,9,156
2018,Kazakhstan,KAZ,-,-,26,34,23,1187,38,332,1640,31,42,51,1822,7,257,2210,8353
2018,Kenya,KEN,-,-,444,409,365,1430,178,80,2906,501,438,371,944,137,71,2462,14767
2018,Kyrgyzstan,KGZ,-,-,31,90,72,287,18,154,652,35,101,46,447,10,169,808,5655
2018,Rep. of Korea,KOR,-,-,0,0,0,39,6,0,45,0,0,0,56,7,0,63,810
2018,Dem. People's Rep. of Korea,PRK,-,-,8,5,5,31,0,0,49,0,0,14,35,0,0,49,943
2018,Kuwait,KWT,-,-,12,36,49,91,0,22,210,14,53,36,89,0,99,291,2471
2018,Lao People's Dem. Rep.,LAO,-,-,0,0,6,0,8,3177,3191,0,5,0,36,7,3562,3610,7237
2018,Liberia,LBR,-,-,110,174,196,946,42,82,1550,122,186,169,1319,38,173,2007,8582
2018,Libya,LBY,-,-,231,301,222,839,21,90666,92280,233,369,189,1943,45,80733,83512,191153
2018,Saint Lucia,LCA,-,-,0,0,15,30,0,0,45,0,6,9,24,0,0,39,1090
2018,Lebanon,LBN,-,-,257,252,278,1377,128,47,2339,248,366,265,1770,72,110,2831,13692
2018,Lesotho,LSO,-,-,0,0,0,0,0,0,0,0,0,0,5,0,0,5,44
2018,Sri Lanka,LKA,-,-,215,236,205,1875,298,9568,12397,215,278,230,6342,288,18766,26119,163945
2018,Lithuania,LTU,-,-,0,0,5,5,0,0,10,0,0,0,0,0,9,9,155
2018,Luxembourg,LUX,-,-,0,0,0,0,0,0,0,0,0,0,0,0,0,0,5
2018,Latvia,LVA,-,-,0,0,0,0,0,16,16,0,0,0,18,0,17,35,255
2018,"China, Macao SAR",MAC,-,-,0,0,0,0,0,0,0,0,0,0,0,0,0,0,25
2018,Madagascar,MDG,-,-,0,0,0,20,0,112,132,5,5,0,5,0,106,121,409
2018,Mauritania,MRT,-,-,1195,3893,2587,6593,650,1320,16238,1277,3950,2566,6330,776,4099,18998,45171
2018,North Macedonia,MKD,-,-,159,202,222,759,78,181,1601,175,259,200,750,45,186,1615,4949
2018,Monaco,MCO,-,-,0,0,0,0,0,0,0,0,0,0,0,0,0,0,5
2018,Rep. of Moldova,MDA,-,-,70,73,98,350,27,160,778,74,97,67,306,8,159,711,6934
2018,Maldives,MDV,-,-,0,0,5,0,0,5,10,0,0,0,5,6,0,11,109
2018,Mexico,MEX,-,-,0,5,0,68,0,15,88,0,12,11,49,0,14,86,102664
2018,Marshall Islands,MHL,-,-,0,0,0,0,0,0,0,0,0,0,0,0,0,0,7
2018,Mali,MLI,-,-,11597,18163,11286,30805,2569,3802,78222,11882,18057,11086,20541,2592,981,65139,289456
2018,Malaysia,MYS,-,-,5,12,5,313,0,5,340,0,12,0,1129,0,6,1147,15854
2018,Malawi,MWI,-,-,16,14,0,105,0,0,135,13,13,0,108,0,0,134,3272
2018,Mongolia,MNG,-,-,128,92,68,573,24,265,1150,101,137,41,497,10,185,971,6643
2018,Morocco,MAR,-,-,111,59,53,812,18,211,1264,120,70,69,1497,16,461,2233,12056
2018,Mozambique,MOZ,-,-,142,222,113,3578,44,5,4104,139,213,121,3472,25,6,3976,9034
2018,Malta,MLT,-,-,0,0,0,0,0,0,0,0,0,0,0,0,0,0,15
2018,Montenegro,MNE,-,-,36,37,35,187,31,50,376,34,43,36,158,13,44,328,1348
2018,Mauritius,MUS,-,-,0,10,0,29,0,16,55,0,6,0,23,0,10,39,450
2018,Myanmar,MMR,-,-,110856,132940,89630,338552,31610,5571,709159,114995,139732,91476,331105,27107,5800,710215,1546012
2018,Namibia,NAM,-,-,25,56,53,124,0,0,258,34,61,61,485,39,0,680,1663
2018,Nepal,NPL,-,-,5,9,11,468,10,54,557,13,5,20,438,0,97,573,17992
2018,Netherlands (Kingdom of the),NLD,-,-,10,0,0,6,0,0,16,9,0,0,5,0,0,14,132
2018,Niger,NER,-,-,9373,20319,8477,30210,2725,31,71135,9355,19551,7528,20794,3682,58,60968,186636
2018,Nicaragua,NIC,-,-,31,52,19,308,10,13,433,33,46,44,665,6,21,815,33936
2018,Nigeria,NGA,-,-,24491,34445,15706,59305,4471,1796,140214,24840,33853,15045,49039,4888,833,128498,2530807
2018,Niue,NIU,-,-,0,0,0,0,0,0,0,0,0,0,0,0,0,0,24
2018,Norway,NOR,-,-,0,0,0,0,0,0,0,0,0,0,0,0,0,0,16
2018,New Zealand,NZL,-,-,0,0,0,0,0,0,0,0,0,0,8,0,0,8,48
2018,Oman,OMN,-,-,0,0,6,0,0,0,6,0,9,0,0,0,0,9,70
2018,Pakistan,PAK,-,-,16267,19541,10888,42561,4127,319,93703,17490,22931,12410,56947,5513,1460,116751,303969
2018,Panama,PAN,-,-,8,0,0,0,0,0,8,0,0,0,0,0,0,0,185
2018,Paraguay,PRY,-,-,5,0,0,8,0,6,19,0,0,0,14,0,0,14,351
2018,Peru,PER,-,-,0,5,7,273,65,140,490,0,5,5,249,66,183,508,7474
2018,Philippines,PHL,-,-,16,10,5,409,5,39608,40053,14,27,0,358,0,38048,38447,162015
2018,Papua New Guinea,PNG,-,-,0,0,0,0,0,0,0,0,0,0,0,0,0,0,869
2018,Poland,POL,-,-,0,0,5,67,118,65,255,5,0,6,139,325,74,549,1997
2018,Portugal,PRT,-,-,0,10,0,0,0,5,15,0,0,0,6,0,0,6,265
2018,Qatar,QAT,-,-,0,0,0,0,0,0,0,0,0,0,0,0,0,0,63
2018,Romania,ROU,-,-,5,0,10,34,39,70,158,6,5,7,51,82,90,241,5408
2018,South Africa,ZAF,-,-,26,41,39,209,6,19,340,33,71,17,258,7,23,409,2886
2018,Russian Federation,RUS,-,-,1629,1868,2667,7823,730,8848,23565,1889,3121,1891,7999,382,8047,23329,104725
2018,Rwanda,RWA,-,-,25408,33526,23159,46628,2717,1956,133394,22120,34518,24681,47855,3648,1468,134290,276239
2018,El Salvador,SLV,-,-,161,217,175,1497,41,23,2114,192,259,228,2396,33,32,3140,250619
2018,Saudi Arabia,SAU,-,-,12,48,12,146,0,7,225,5,38,39,89,0,5,176,2938
2018,Serbia and Kosovo: S/RES/1244 (1999),SRB,-,-,3422,9701,10598,65478,27596,6909,123704,3483,9758,11905,67896,22991,7469,123502,257864
2018,Senegal,SEN,-,-,246,452,375,1174,108,897,3252,280,459,369,2283,166,481,4038,35617
2018,Seychelles,SYC,-,-,0,0,0,0,0,0,0,0,0,0,0,0,0,0,15
2018,Singapore,SGP,-,-,0,0,0,0,0,0,0,0,8,0,0,0,0,8,116
2018,Sierra Leone,SLE,-,-,229,229,250,1201,6,216,2131,140,208,270,2462,13,377,3470,12268
2018,Solomon Islands,SLB,-,-,0,0,0,6,0,0,6,0,0,0,0,0,0,0,178
2018,Somalia,SOM,-,-,383617,377876,217325,751572,27433,1937,1759760,403445,393030,220783,720839,28740,3335,1770172,3653620
2018,Spain,ESP,-,-,0,10,13,5,0,0,28,0,12,10,12,7,5,46,284
2018,Viet Nam,VNM,-,-,64,116,98,696,199,3912,5085,94,122,95,1155,237,4908,6611,340103
2018,Saint Kitts and Nevis,KNA,-,-,0,0,0,0,0,0,0,0,0,0,5,0,0,5,69
2018,Sao Tome and Principe,STP,-,-,0,5,0,10,0,5,20,0,5,0,6,0,0,11,56
2018,Sudan,SDN,-,-,61046,87862,58158,163735,13051,1287,385139,63232,89095,57539,134352,11416,13573,369207,2656415
2018,Suriname,SUR,-,-,0,7,0,0,0,5,12,0,0,0,0,0,0,0,79
2018,South Sudan,SSD,-,-,200058,306137,181666,456946,44778,1020347,2209932,203334,312939,200665,327691,26935,903647,1975211,4186156
2018,Slovakia,SVK,-,-,0,13,10,46,17,57,143,0,13,9,65,37,56,180,1608
2018,Slovenia,SVN,-,-,0,0,0,0,0,0,0,0,0,0,0,6,0,6,29
2018,Eswatini,SWZ,-,-,0,0,0,25,0,0,25,0,0,5,22,0,0,27,285
2018,Sweden,SWE,-,-,8,0,0,0,0,0,8,0,0,0,0,0,0,0,45
2018,Switzerland,CHE,-,-,0,0,0,0,0,0,0,0,0,0,0,0,0,0,18
2018,Syrian Arab Rep.,SYR,-,-,467034,575002,351577,1424851,101950,10955,2931369,497761,613917,399823,1780415,90713,13455,3396084,12986323
2018,United Rep. of Tanzania,TZA,-,-,43,33,28,115,0,0,219,37,41,11,275,0,17,381,2392
2018,Turks and Caicos Islands,TCA,-,-,0,0,0,0,0,0,0,0,0,0,0,0,0,0,14
2018,Thailand,THA,-,-,0,5,0,414,0,0,419,0,0,0,103,7,6,116,2975
2018,Tajikistan,TJK,-,-,235,202,171,652,36,32,1328,269,254,157,1076,8,39,1803,4887
2018,Turkmenistan,TKM,-,-,29,16,34,612,10,17,718,24,38,16,241,0,11,330,1721
2018,Timor-Leste,TLS,-,-,0,0,0,0,0,0,0,0,0,0,0,0,0,0,22
2018,Togo,TGO,-,-,152,348,311,1450,109,507,2877,148,354,280,2914,143,800,4639,11575
2018,Tonga,TON,-,-,0,0,0,0,0,0,0,0,0,0,0,0,0,0,202
2018,Trinidad and Tobago,TTO,-,-,0,0,0,7,0,0,7,5,0,0,16,0,0,21,643
2018,Tunisia,TUN,-,-,31,46,29,238,8,184,536,38,34,45,614,7,367,1105,4734
2018,Türkiye,TUR,-,-,1742,2693,2835,17216,2673,4378,31537,1879,3052,2798,27887,2433,10151,48200,111825
2018,United Arab Emirates,ARE,-,-,5,5,0,7,0,0,17,0,16,6,24,7,0,53,441
2018,Uganda,UGA,-,-,181,259,186,1273,21,66,1986,195,229,185,1490,44,102,2245,197990
2018,Ukraine,UKR,-,-,282,287,310,1822,302,976,3979,248,413,215,1548,138,785,3347,1625215
2018,Uruguay,URY,-,-,0,5,0,0,0,0,5,0,0,0,5,0,0,5,210
2018,United States of America,USA,-,-,25,33,29,44,11,0,142,16,30,30,64,10,0,150,3166
2018,Uzbekistan,UZB,-,-,26,104,63,523,29,143,888,52,94,94,439,12,118,809,7882
2018,Vanuatu,VUT,-,-,0,0,0,0,0,0,0,0,0,0,0,0,0,0,52
2018,Saint Vincent and the Grenadines,VCT,-,-,0,6,11,44,0,0,61,0,5,7,23,0,0,35,1314
2018,Venezuela (Bolivarian Republic of),VEN,-,-,4131,5001,2901,85248,1313,609384,707978,4489,5197,3225,132231,902,562480,708524,3078217
2018,Samoa,WSM,-,-,0,0,0,0,0,0,0,0,0,0,0,0,0,0,42
2018,Western Sahara,ESH,-,-,0,0,0,31,0,98,129,0,0,0,119,0,484,603,118593
2018,Yemen,YEM,-,-,151986,217810,216879,483596,43780,245,1114296,130604,239468,217259,456669,44032,369,1088401,2211740
2018,Zambia,ZMB,-,-,0,0,12,15,0,5,32,0,0,0,0,0,0,0,520
2018,Zimbabwe,ZWE,-,-,119,174,119,978,21,26,1437,123,181,111,845,16,27,1303,32849
2018,Stateless,XXA,-,-,450,703,566,2632,178,168,4697,441,850,684,5412,253,363,8003,62871
2018,Tibetan,TIB,-,-,0,0,0,7003,0,0,7003,0,0,0,6506,0,0,6506,13527
2018,Guadeloupe,GLP,-,-,0,0,0,0,0,0,0,0,0,0,0,0,0,0,11
2018,Curacao ,CUW,-,-,0,0,0,0,0,0,0,0,0,0,0,0,0,0,35
2018,Unknown ,UNK,-,-,2458,2244,1786,8574,606,1578,17246,2664,2784,2276,18211,688,3234,29857,429348
2019,Afghanistan,AFG,-,-,379088,486135,372010,937456,94087,17939,2286715,378944,521686,409623,1079519,116967,54435,2561174,5982668
2019,Albania,ALB,-,-,231,326,225,1348,70,6908,9108,286,330,315,1564,55,8443,10993,34034
2019,Algeria,DZA,-,-,86,78,29,430,16,1347,1986,102,101,54,1527,39,3497,5320,12324
2019,Angola,AGO,-,-,1400,2372,1607,5013,533,1924,12849,1353,2297,1634,4122,926,2349,12681,37191
2019,Antigua and Barbuda,ATG,-,-,0,0,0,0,0,0,0,0,0,0,0,0,9,9,182
2019,Egypt,EGY,-,-,308,477,294,1235,57,803,3174,277,554,324,2834,77,3627,7693,44392
2019,Argentina,ARG,-,-,0,0,5,22,0,150,177,10,8,0,21,7,178,224,1036
2019,Armenia,ARM,-,-,383,401,269,2367,512,2691,6623,364,489,387,2526,358,2704,6828,22064
2019,Australia,AUS,-,-,0,5,0,0,0,0,5,0,0,5,0,0,0,5,70
2019,Austria,AUT,-,-,0,5,0,0,0,0,5,0,0,0,0,0,0,0,28
2019,Azerbaijan,AZE,-,-,470,648,332,3022,628,1883,6983,487,776,466,3157,398,2021,7305,672184
2019,Bahrain,BHR,-,-,5,11,18,19,0,6,59,12,9,5,84,0,21,131,713
2019,Barbados,BRB,-,-,0,0,0,0,0,0,0,0,0,0,0,0,5,5,359
2019,Burundi,BDI,-,-,42610,44113,29696,108804,5348,575,231146,42573,45661,30009,112511,4855,702,236311,484927
2019,Belgium,BEL,-,-,0,0,0,6,0,0,6,0,0,0,0,0,0,0,139
2019,Benin,BEN,-,-,33,5,0,81,0,60,179,20,5,6,225,0,82,338,1941
2019,Bangladesh,BGD,-,-,51,45,28,245,5,1605,1979,55,41,46,2147,19,10668,12976,86128
2019,Bahamas,BHS,-,-,0,0,0,0,0,0,0,0,0,0,0,0,0,0,1029
2019,Bhutan,BTN,-,-,224,400,357,1679,320,22,3002,235,428,389,1946,453,104,3555,7252
2019,Burkina Faso,BFA,-,-,51793,76214,41132,112965,8553,188,290845,51988,78414,45855,92926,9148,340,278671,578952
2019,Belarus,BLR,-,-,24,45,19,199,12,371,670,22,43,30,202,22,477,796,7437
2019,Bolivia (Plurinational State of),BOL,-,-,5,13,5,54,0,92,169,10,0,0,57,0,114,181,1752
2019,Botswana,BWA,-,-,0,0,5,23,0,52,80,0,5,7,15,0,11,38,367
2019,Brazil,BRA,-,-,258,20,19,96,5,544,942,274,29,6,130,0,628,1067,13433
2019,Brunei Darussalam,BRN,-,-,0,0,0,0,0,0,0,0,0,0,0,0,0,0,10
2019,Bosnia and Herzegovina,BIH,-,-,55,83,82,830,222,73250,74522,70,101,77,707,151,76313,77419,163371
2019,Bulgaria,BGR,-,-,0,7,0,15,11,27,60,0,10,5,10,33,48,106,915
2019,Belize,BLZ,-,-,0,0,0,7,0,0,7,6,0,5,11,0,0,22,351
2019,Cambodia,KHM,-,-,12,8,45,211,12,5434,5722,8,27,24,205,19,5587,5870,12832
2019,Canada,CAN,-,-,5,7,0,7,0,0,19,0,5,5,5,0,12,27,159
2019,Central African Rep.,CAF,-,-,105137,166465,87193,293420,21153,1707,675075,108491,146654,88316,255502,20272,1791,621026,1297563
2019,Cayman Islands,CYM,-,-,0,0,0,0,0,0,0,0,0,0,0,0,0,0,6
2019,Chad,TCD,-,-,25166,35654,25101,74804,6583,653,167961,25828,35649,23664,45935,4446,1353,136875,309143
2019,China,CHN,-,-,189,156,93,1882,134,4689,7143,207,181,120,2379,134,5873,8894,317111
2019,Chile,CHL,-,-,191,0,5,71,38,125,430,184,5,0,63,73,135,460,1737
2019,Cameroon,CMR,-,-,4501,6031,3610,15813,1080,494497,525532,4666,5805,3479,14215,665,460103,488933,1038379
2019,Congo,COG,-,-,121,166,131,530,19,1926,2893,74,173,166,853,56,2089,3411,158437
2019,Dem. Rep. of the Congo,COD,-,-,584907,778607,449386,1145240,73018,10726,3041884,548766,785945,464464,961847,64497,11654,2837173,5975857
2019,Comoros,COM,-,-,0,5,9,123,0,229,366,0,7,5,221,0,409,642,2117
2019,Colombia,COL,-,-,5084,6813,8500,12746,1741,4323970,4358854,5159,6905,8631,13183,1756,4087720,4123354,8641214
2019,Costa Rica,CRI,-,-,6,5,10,6,0,35,62,0,0,9,17,0,41,67,945
2019,Cuba,CUB,-,-,193,205,150,6491,88,846,7973,160,272,165,12701,112,1315,14725,62569
2019,Cabo Verde,CPV,-,-,0,5,0,0,0,0,5,0,0,0,10,0,0,10,260
2019,Cyprus,CYP,-,-,0,0,0,0,0,0,0,0,0,0,0,0,6,6,35
2019,Czechia,CZE,-,-,0,0,0,74,203,10,287,0,0,0,110,339,14,463,1347
2019,Denmark,DNK,-,-,0,0,0,0,0,0,0,0,0,0,0,0,0,0,42
2019,Djibouti,DJI,-,-,5,13,5,42,5,232,302,0,15,8,58,0,160,241,3185
2019,Dominica,DMA,-,-,0,0,0,0,0,29,29,0,0,0,0,0,15,15,132
2019,Dominican Rep.,DOM,-,-,5,0,7,420,0,217,649,5,5,5,328,0,114,457,4584
2019,Ecuador,ECU,-,-,5,14,12,36,0,134,201,10,5,14,46,5,159,239,20984
2019,Equatorial Guinea,GNQ,-,-,0,5,5,12,0,46,68,0,0,0,12,6,64,82,322
2019,Eritrea,ERI,-,-,17972,25097,22848,111956,6595,2860,187328,18630,28140,28667,133306,7581,6723,223047,576598
2019,Estonia,EST,-,-,0,0,0,0,0,0,0,0,0,5,0,0,5,10,329
2019,Ethiopia,ETH,-,-,6860,9675,6476,39837,1474,1368,65690,7332,10196,7168,41196,1830,1901,69623,1966243
2019,French Guiana,GUF,-,-,0,0,0,0,0,0,0,0,0,0,0,0,0,0,24
2019,Fiji,FJI,-,-,0,0,0,0,0,0,0,0,0,0,0,0,5,5,2934
2019,Finland,FIN,-,-,0,0,0,0,0,0,0,0,0,0,0,0,5,5,10
2019,France,FRA,-,-,0,0,0,0,0,0,0,0,5,5,10,5,5,30,318
2019,Gabon,GAB,-,-,7,0,0,27,0,152,186,7,0,0,28,0,128,163,1333
2019,Gambia,GMB,-,-,138,66,43,587,0,414,1248,103,66,111,5323,7,1052,6662,26974
2019,Palestinian,PSE,-,-,486,1185,866,4844,901,36478,44760,428,1219,968,5539,1009,38706,47869,108894
2019,United Kingdom of Great Britain and Northern Ireland,GBR,-,-,5,0,0,5,0,0,10,7,6,0,7,0,5,25,296
2019,Georgia,GEO,-,-,10955,18000,10972,80535,34458,4240,159160,11457,19091,12052,73462,21720,4459,142241,313469
2019,Germany,DEU,-,-,0,0,0,0,0,5,5,0,0,0,0,0,10,10,270
2019,Ghana,GHA,-,-,1375,1453,567,2760,310,529,6994,1316,1577,608,2110,164,1317,7092,28983
2019,Guinea-Bissau,GNB,-,-,20,13,0,67,0,335,435,10,10,13,280,0,745,1058,4758
2019,Greece,GRC,-,-,0,0,0,0,7,0,7,0,0,0,11,33,0,44,228
2019,Grenada,GRD,-,-,0,0,0,0,0,14,14,0,0,0,0,0,15,15,169
2019,Guatemala,GTM,-,-,173,233,174,1023,16,286,1905,163,261,175,1471,31,408,2509,190127
2019,Guinea,GIN,-,-,465,245,168,1865,17,6631,9391,433,224,654,6648,12,6742,14713,57266
2019,Guyana,GUY,-,-,0,0,0,0,0,5,5,5,0,0,5,0,28,38,960
2019,Haiti,HTI,-,-,125,224,113,2380,28,1744,4614,113,188,93,3394,47,2142,5977,92418
2019,"China, Hong Kong SAR",HKG,-,-,0,0,0,0,0,0,0,0,0,0,0,0,16,16,227
2019,Honduras,HND,-,-,1429,2012,1117,7874,96,143657,156185,1510,2245,1532,11901,136,118584,135908,468758
2019,Croatia,HRV,-,-,5,19,179,3365,1251,30,4849,5,9,156,3308,884,31,4393,27612
2019,Hungary,HUN,-,-,0,5,0,12,65,20,102,0,0,0,30,139,34,203,4683
2019,Iceland,ISL,-,-,0,0,0,5,0,0,5,0,0,0,0,0,0,0,10
2019,Cote d'Ivoire,CIV,-,-,1360,2104,1754,7149,401,3967,16735,1343,2117,1629,9043,318,3002,17452,59264
2019,India,IND,-,-,70,52,43,614,25,953,1757,93,54,55,1041,40,2646,3929,78046
2019,Indonesia,IDN,-,-,12,5,0,1003,5,64,1089,0,13,5,12,5,51,86,16362
2019,Ireland,IRL,-,-,0,0,0,0,0,0,0,0,0,0,0,0,0,0,90
2019,Iran (Islamic Rep. of),IRN,-,-,2372,3835,3198,32230,2344,6018,49997,2364,4201,3656,51612,2915,12403,77151,215496
2019,Iraq,IRQ,-,-,18775,42091,27953,119894,12625,12632,233970,20455,45092,31765,149989,11180,21631,280112,2085397
2019,Israel,ISR,-,-,0,9,5,23,0,21,58,0,0,13,30,5,26,74,1142
2019,Italy,ITA,-,-,5,15,0,6,0,0,26,5,7,0,11,0,5,28,507
2019,Jamaica,JAM,-,-,0,0,0,20,0,71,91,5,0,0,129,0,158,292,4327
2019,Jordan,JOR,-,-,83,98,66,2143,47,232,2669,69,101,65,446,11,403,1095,8984
2019,Japan,JPN,-,-,0,0,9,10,0,0,19,0,0,9,0,0,9,18,150
2019,Kazakhstan,KAZ,-,-,10,21,12,123,27,536,729,10,33,18,130,6,485,682,9739
2019,Kenya,KEN,-,-,453,467,333,1462,176,352,3243,535,463,377,952,123,195,2645,15589
2019,Kyrgyzstan,KGZ,-,-,49,65,24,162,11,221,532,38,60,32,154,10,315,609,5556
2019,Rep. of Korea,KOR,-,-,0,0,0,17,5,5,27,0,0,5,25,0,5,35,823
2019,Dem. People's Rep. of Korea,PRK,-,-,5,0,5,48,6,14,78,0,0,5,61,7,10,83,870
2019,Kuwait,KWT,-,-,0,40,51,95,0,240,426,6,37,73,89,0,394,599,2712
2019,Lao People's Dem. Rep.,LAO,-,-,0,0,0,0,7,3045,3052,0,0,5,32,8,3419,3464,7147
2019,Liberia,LBR,-,-,120,198,217,982,53,96,1666,138,197,225,1182,51,263,2056,8351
2019,Libya,LBY,-,-,180,311,178,819,29,771,2288,211,376,191,1851,45,1698,4372,377733
2019,Saint Lucia,LCA,-,-,0,0,0,0,0,16,16,0,0,0,0,0,11,11,917
2019,Lebanon,LBN,-,-,290,465,311,4803,429,507,6805,284,587,376,1643,95,740,3725,18709
2019,Lesotho,LSO,-,-,0,0,0,5,0,0,5,0,0,0,0,0,5,5,55
2019,Liechtenstein,LIE,-,-,0,0,0,0,0,0,0,0,0,0,0,0,0,0,14
2019,Sri Lanka,LKA,-,-,223,361,188,2135,434,38346,41687,237,299,284,6089,378,46657,53944,151523
2019,Lithuania,LTU,-,-,0,0,0,5,0,0,5,0,0,0,0,0,13,13,137
2019,Luxembourg,LUX,-,-,0,0,0,5,0,0,5,0,0,0,0,0,0,0,5
2019,Latvia,LVA,-,-,0,5,0,0,0,15,20,0,0,0,13,0,17,30,242
2019,"China, Macao SAR",MAC,-,-,0,0,0,0,0,0,0,0,0,0,0,0,5,5,33
2019,Madagascar,MDG,-,-,5,0,0,17,0,119,141,0,8,0,0,0,105,113,562
2019,Mauritania,MRT,-,-,951,3865,2711,6654,721,1394,16296,1050,3946,2687,6383,819,4439,19324,46003
2019,North Macedonia,MKD,-,-,132,176,160,627,67,283,1445,119,214,136,639,49,303,1460,4310
2019,Monaco,MCO,-,-,0,0,0,0,0,0,0,0,0,0,0,0,0,0,5
2019,Rep. of Moldova,MDA,-,-,121,123,82,431,42,347,1146,107,129,78,470,22,326,1132,8080
2019,Maldives,MDV,-,-,0,0,5,0,0,5,10,0,0,0,0,0,5,5,86
2019,Mexico,MEX,-,-,0,0,0,25,0,121,146,0,5,7,21,0,159,192,116275
2019,Marshall Islands,MHL,-,-,0,0,0,0,0,0,0,0,0,0,0,0,0,0,7
2019,Mali,MLI,-,-,11415,19036,12292,32117,2584,115400,192844,11492,18851,12046,21142,2616,99449,165596,380804
2019,Malaysia,MYS,-,-,0,6,0,29,0,141,176,0,8,0,20,0,211,239,22165
2019,Malawi,MWI,-,-,14,19,10,106,0,55,204,12,11,5,110,0,30,168,3084
2019,Mongolia,MNG,-,-,68,59,24,255,23,548,977,59,85,43,179,12,460,838,6431
2019,Morocco,MAR,-,-,116,78,34,693,19,1050,1990,108,94,83,1359,13,3122,4779,13224
2019,Mozambique,MOZ,-,-,154,233,135,325,46,5,898,154,234,122,217,28,23,778,189327
2019,Malta,MLT,-,-,0,0,0,0,0,0,0,0,0,0,0,0,0,0,20
2019,Montenegro,MNE,-,-,23,36,29,171,33,62,354,25,35,35,141,12,59,307,1265
2019,Mauritius,MUS,-,-,5,10,0,15,0,63,93,0,0,5,20,0,68,93,482
2019,Myanmar,MMR,-,-,116488,124735,87920,324036,24185,24377,701741,119595,129776,92706,330155,26484,19704,718420,1426420
2019,Namibia,NAM,-,-,0,0,0,14,0,374,388,0,0,0,21,0,285,306,1215
2019,Nepal,NPL,-,-,10,0,10,384,9,261,674,11,5,0,138,0,469,623,18319
2019,Netherlands (Kingdom of the),NLD,-,-,9,0,0,7,0,0,16,15,0,0,5,0,0,20,157
2019,Niger,NER,-,-,10812,22719,9423,29084,3509,50,75597,9651,20263,8419,26507,3138,160,68138,227267
2019,Nicaragua,NIC,-,-,79,97,46,666,15,3073,3976,73,96,91,1352,16,3490,5118,71469
2019,Nigeria,NGA,-,-,29130,43969,19169,68018,5196,5054,170536,27718,41212,17343,54701,5151,4160,150285,2603746
2019,Niue,NIU,-,-,0,0,0,0,0,0,0,0,0,0,0,0,0,0,25
2019,Norway,NOR,-,-,0,0,0,0,0,0,0,0,0,0,0,0,0,0,16
2019,Nauru,NRU,-,-,0,0,0,0,0,0,0,0,0,0,0,0,0,0,15
2019,New Zealand,NZL,-,-,0,0,0,0,0,0,0,0,0,0,8,0,0,8,61
2019,Oman,OMN,-,-,0,5,0,0,0,6,11,0,15,0,0,0,16,31,1075
2019,Pakistan,PAK,-,-,16542,19894,10873,42729,4139,2227,96404,17866,23315,12555,50693,5530,14900,124859,306698
2019,Panama,PAN,-,-,5,0,0,0,0,30,35,6,0,0,0,0,40,46,285
2019,Paraguay,PRY,-,-,5,0,0,9,0,176,190,0,0,0,21,0,185,206,716
2019,Peru,PER,-,-,10,0,0,255,71,2062,2398,11,0,5,242,74,1966,2298,11434
2019,Philippines,PHL,-,-,18,11,10,101,5,91415,91560,10,27,0,5,0,87720,87762,239212
2019,Papua New Guinea,PNG,-,-,0,0,0,0,0,0,0,0,0,0,0,0,0,0,1024
2019,Poland,POL,-,-,0,0,5,42,128,62,237,0,0,5,109,330,70,514,1977
2019,Portugal,PRT,-,-,0,0,5,0,0,0,5,0,0,5,5,0,5,15,363
2019,Qatar,QAT,-,-,0,0,5,0,0,5,10,0,0,0,0,0,5,5,72
2019,Romania,ROU,-,-,0,5,12,32,39,61,149,6,5,6,43,79,93,232,5262
2019,South Africa,ZAF,-,-,54,50,40,265,11,112,532,35,79,24,179,14,110,441,3286
2019,Russian Federation,RUS,-,-,1339,2654,1629,6701,752,11070,24145,1462,2887,1840,6294,401,10511,23395,110635
2019,Rwanda,RWA,-,-,25361,33306,23142,48017,2781,1647,134254,22187,34297,24627,48383,3769,1538,134801,277699
2019,El Salvador,SLV,-,-,376,499,353,3073,73,3677,8051,390,574,472,4673,61,3736,9906,282785
2019,Saudi Arabia,SAU,-,-,17,53,5,102,0,124,301,11,50,40,61,0,80,242,3157
2019,Serbia and Kosovo: S/RES/1244 (1999),SRB,-,-,1256,1628,1667,8163,2327,7115,22156,1357,1678,1689,9080,2215,7741,23760,253410
2019,Senegal,SEN,-,-,197,691,576,1686,245,1178,4573,215,679,585,2855,235,1670,6239,32539
2019,Seychelles,SYC,-,-,0,0,0,0,0,6,6,0,0,0,0,0,0,0,21
2019,Singapore,SGP,-,-,0,0,0,0,0,0,0,0,8,0,0,0,5,13,127
2019,Sierra Leone,SLE,-,-,320,349,246,1197,32,447,2591,290,290,337,2256,32,846,4051,12560
2019,Solomon Islands,SLB,-,-,0,0,0,6,0,0,6,0,0,0,0,0,0,0,261
2019,Somalia,SOM,-,-,389940,363140,209037,739112,27050,3993,1732272,409939,378283,213198,716324,28344,6520,1752608,3602839
2019,Spain,ESP,-,-,0,17,5,5,0,0,27,0,7,16,5,6,0,34,327
2019,Viet Nam,VNM,-,-,72,106,90,666,222,4391,5547,84,118,87,1053,264,6049,7655,324604
2019,Saint Kitts and Nevis,KNA,-,-,0,0,0,0,0,6,6,0,0,0,0,0,6,6,74
2019,Sao Tome and Principe,STP,-,-,0,5,0,11,0,10,26,0,0,0,7,0,0,7,57
2019,Sudan,SDN,-,-,62198,87155,58994,167436,12476,1071543,1459802,64131,88878,59540,136794,10839,834907,1195089,2692586
2019,Suriname,SUR,-,-,0,0,0,0,0,5,5,0,0,0,0,0,5,5,89
2019,South Sudan,SSD,-,-,187219,287166,186728,462275,44504,25,1167917,189728,294621,204209,352953,29988,127,1071626,3916236
2019,Slovakia,SVK,-,-,0,0,0,10,17,55,82,0,0,0,18,33,57,108,1574
2019,Slovenia,SVN,-,-,0,0,0,0,0,0,0,0,0,0,0,6,0,6,34
2019,Eswatini,SWZ,-,-,0,0,5,21,0,0,26,0,6,5,14,0,0,25,321
2019,Sweden,SWE,-,-,8,0,0,0,0,0,8,0,0,0,0,0,0,0,48
2019,Switzerland,CHE,-,-,0,0,0,0,0,0,0,0,0,0,0,0,0,0,25
2019,Syrian Arab Rep.,SYR,-,-,468477,595529,344087,1416959,99811,20310,2945173,498871,632132,385735,1759640,89024,27631,3393033,12888305
2019,United Rep. of Tanzania,TZA,-,-,60,37,18,173,5,99,392,66,58,14,282,0,116,536,2703
2019,Turks and Caicos Islands,TCA,-,-,0,0,0,0,0,0,0,0,0,0,0,0,0,0,14
2019,Thailand,THA,-,-,0,10,0,41,0,61,112,0,7,0,19,7,20,53,3704
2019,Tajikistan,TJK,-,-,195,206,90,536,30,103,1160,212,220,112,808,13,199,1564,4648
2019,Turkmenistan,TKM,-,-,14,29,19,77,13,24,176,19,40,11,87,0,50,207,1054
2019,Timor-Leste,TLS,-,-,0,0,0,0,0,0,0,0,0,0,0,0,8,8,58
2019,Togo,TGO,-,-,144,336,310,1454,117,262,2623,161,319,275,2868,164,759,4546,11414
2019,Tonga,TON,-,-,0,0,0,0,0,0,0,0,0,0,0,0,0,0,451
2019,Trinidad and Tobago,TTO,-,-,0,0,0,5,0,41,46,0,0,0,15,0,68,83,915
2019,Tunisia,TUN,-,-,34,40,31,221,10,213,549,38,34,25,487,14,809,1407,4750
2019,Türkiye,TUR,-,-,1892,3241,2764,18481,2685,7175,36238,2042,3398,2969,30304,2542,14626,55881,130237
2019,United Arab Emirates,ARE,-,-,6,6,5,10,0,0,27,0,7,0,10,0,8,25,336
2019,Uganda,UGA,-,-,205,246,164,988,32,466,2101,173,231,179,1435,68,440,2526,2323247
2019,Ukraine,UKR,-,-,199,341,182,1366,298,1356411,1358797,201,385,198,1117,144,1067184,1069229,2502092
2019,Uruguay,URY,-,-,0,5,0,0,0,60,65,5,0,0,5,0,60,70,326
2019,United States of America,USA,-,-,21,26,36,43,10,98,234,5,21,28,61,16,123,254,3249
2019,Uzbekistan,UZB,-,-,11,31,23,138,19,456,678,28,49,23,135,8,1316,1559,8219
2019,Vanuatu,VUT,-,-,0,0,0,0,0,0,0,0,0,0,0,0,0,0,75
2019,Holy See,VAT,-,-,0,0,0,0,0,0,0,0,0,0,0,0,0,0,5
2019,Saint Vincent and the Grenadines,VCT,-,-,0,0,0,0,0,5,5,0,0,0,5,0,11,16,1056
2019,Venezuela (Bolivarian Republic of),VEN,-,-,1719,47902,59888,191426,15637,872105,1188677,1980,35429,43614,142746,11701,940969,1176439,4964435
2019,Samoa,WSM,-,-,0,0,0,0,0,0,0,0,0,0,0,0,0,0,84
2019,Western Sahara,ESH,-,-,0,0,0,24,0,134,158,0,0,0,99,0,647,746,117868
2019,Yemen,YEM,-,-,255522,365915,365104,809444,73470,637,1870092,219361,402378,365427,753315,73732,1874,1816087,3696615
2019,Zambia,ZMB,-,-,0,5,5,25,0,26,61,0,0,0,5,0,20,25,723
2019,Zimbabwe,ZWE,-,-,115,189,112,1093,20,257,1786,127,195,118,869,5,228,1542,296343
2019,Stateless,XXA,-,-,141353,112719,70365,411906,37665,247291,1021299,147699,132219,65918,330867,42951,248830,968484,3009282
2019,Tibetan,TIB,-,-,0,0,0,6520,0,0,6520,0,0,0,6020,0,0,6020,12555
2019,Curacao ,CUW,-,-,0,0,0,0,0,0,0,0,0,0,0,0,0,0,35
2019,Unknown ,UNK,-,-,2798,2592,1880,9500,672,76050,93492,2988,2918,2413,18813,808,79785,107725,565166
2020,Afghanistan,AFG,-,-,362894,478849,370034,966784,91943,18599,2289103,367278,492628,401637,1114241,121167,44272,2541223,5807434
2020,Albania,ALB,-,-,165,250,194,1118,47,4661,6435,203,278,211,1242,51,8887,10872,33151
2020,Algeria,DZA,-,-,110,143,60,676,23,1354,2366,149,131,120,2280,51,3028,5759,12446
2020,Andorra,AND,-,-,0,0,0,0,0,0,0,0,0,0,0,0,0,0,5
2020,Angola,AGO,-,-,1484,2542,1763,5540,559,1086,12974,1499,2460,1770,4640,982,2038,13389,39639
2020,Antigua and Barbuda,ATG,-,-,0,0,0,0,0,5,5,0,0,0,0,0,11,11,159
2020,Egypt,EGY,-,-,297,539,397,1394,60,1123,3810,255,561,405,2976,76,3792,8065,42954
2020,Argentina,ARG,-,-,7,0,6,41,0,234,288,8,6,6,47,13,287,367,1293
2020,Armenia,ARM,-,-,235,306,202,1758,403,897,3801,238,354,295,1947,303,1403,4540,19184
2020,Australia,AUS,-,-,0,5,0,0,0,0,5,0,0,5,0,0,0,5,32
2020,Austria,AUT,-,-,0,5,0,0,0,0,5,0,0,0,0,0,0,0,18
2020,Azerbaijan,AZE,-,-,5710,5818,5507,36924,10606,737,65302,5982,6319,6056,10351,5410,1078,35196,761814
2020,Bahrain,BHR,-,-,0,14,14,14,0,0,42,11,9,10,91,0,13,134,652
2020,Barbados,BRB,-,-,0,0,0,38,0,28,66,0,0,0,0,0,49,49,350
2020,Burundi,BDI,-,-,38187,42907,28105,90388,5228,1424,206239,38314,43962,28908,109697,4944,1689,227514,462489
2020,Belgium,BEL,-,-,0,5,0,6,0,0,11,0,0,0,0,0,0,0,90
2020,Benin,BEN,-,-,46,15,0,102,0,177,340,17,11,19,240,0,344,631,1968
2020,Bangladesh,BGD,-,-,48,117,58,806,37,4556,5622,57,119,101,28070,60,13991,42398,556855
2020,Bahamas,BHS,-,-,26,40,24,188,0,39,317,29,48,36,156,0,26,295,1229
2020,Bhutan,BTN,-,-,175,393,350,1717,322,5,2962,180,411,424,1965,459,0,3439,7152
2020,Burkina Faso,BFA,-,-,1227,1611,690,3686,266,571160,578640,1173,1535,673,2354,306,504733,510774,1099600
2020,Belarus,BLR,-,-,12,50,22,176,16,395,671,15,34,34,214,21,668,986,7837
2020,Bolivia (Plurinational State of),BOL,-,-,0,27,0,102,0,85,214,7,5,0,84,20,121,237,1905
2020,Botswana,BWA,-,-,0,0,5,28,0,27,60,0,0,10,12,0,58,80,325
2020,Brazil,BRA,-,-,472,46,26,174,5,732,1455,518,72,17,221,0,937,1765,18405
2020,Brunei Darussalam,BRN,-,-,0,0,0,5,0,0,5,0,0,0,0,0,0,0,10
2020,Bosnia and Herzegovina,BIH,-,-,37,85,72,718,259,47987,49158,49,63,64,618,164,50182,51140,114369
2020,Bulgaria,BGR,-,-,0,5,5,14,10,30,64,0,10,0,19,32,39,100,865
2020,Belize,BLZ,-,-,0,5,0,5,0,0,10,6,6,0,8,0,5,25,382
2020,Cambodia,KHM,-,-,17,17,37,236,12,10,329,15,25,26,225,26,17,334,12778
2020,Canada,CAN,-,-,0,0,7,9,0,10,26,5,0,0,7,0,16,28,173
2020,Central African Rep.,CAF,-,-,115723,168323,88644,276269,22328,222,671509,115386,168521,87902,268527,22418,449,663203,1339218
2020,Cayman Islands,CYM,-,-,0,0,0,0,0,0,0,0,0,0,0,0,0,0,5
2020,Chad,TCD,-,-,35012,59481,26445,113845,14613,619,250015,32651,44281,23186,84208,12604,1281,198211,452578
2020,China,CHN,-,-,182,158,100,2687,126,2185,5438,195,205,147,3560,181,3353,7641,283438
2020,Chile,CHL,-,-,467,6,5,135,42,173,828,436,5,0,128,69,241,879,2770
2020,Cameroon,CMR,-,-,4701,7671,4663,252587,20577,291218,581417,4872,7524,4484,215300,18239,283848,534267,1134441
2020,Congo,COG,-,-,108,318,617,5119,98,597,6857,58,353,595,7452,123,1171,9752,159894
2020,Dem. Rep. of the Congo,COD,-,-,74962,100751,68243,212965,13753,5170,475844,75107,101033,68759,212901,11206,7740,476746,6197972
2020,Comoros,COM,-,-,5,12,5,157,0,660,839,0,6,5,361,0,1467,1839,3436
2020,Colombia,COL,-,-,582874,631782,647252,2412064,287393,52672,4614037,530388,588429,589679,2282804,267242,47142,4305684,9755473
2020,Costa Rica,CRI,-,-,11,5,10,10,0,29,65,7,5,5,19,0,46,82,1008
2020,Cuba,CUB,-,-,165,233,181,6676,129,1510,8894,127,296,191,12486,190,1961,15251,71276
2020,Cabo Verde,CPV,-,-,0,5,0,0,0,0,5,0,0,0,5,0,0,5,263
2020,Cyprus,CYP,-,-,0,0,0,0,0,0,0,0,0,0,0,0,7,7,19
2020,Czechia,CZE,-,-,0,0,0,57,212,44,313,0,0,0,98,339,44,481,1270
2020,Denmark,DNK,-,-,0,0,0,0,0,0,0,0,0,0,0,0,0,0,22
2020,Djibouti,DJI,-,-,0,20,11,49,5,340,425,0,20,13,104,0,367,504,4603
2020,Dominica,DMA,-,-,0,0,0,5,0,7,12,0,0,0,5,0,14,19,129
2020,Dominican Rep.,DOM,-,-,0,5,19,500,0,158,682,0,10,16,401,0,212,639,4794
2020,Ecuador,ECU,-,-,17,15,24,69,0,219,344,33,5,11,105,6,279,439,23779
2020,Equatorial Guinea,GNQ,-,-,0,5,0,18,0,41,64,0,0,0,6,6,58,70,338
2020,Eritrea,ERI,-,-,16406,29316,25631,122974,6819,4412,205558,17255,30451,32326,142597,7830,7690,238149,607383
2020,Estonia,EST,-,-,0,0,0,0,0,0,0,0,0,5,12,0,0,17,320
2020,Ethiopia,ETH,-,-,6985,11916,9556,60560,3244,1161,93422,7739,13084,10685,119659,5247,2050,158464,3014051
2020,French Guiana,GUF,-,-,0,0,0,0,0,0,0,0,0,0,0,0,0,0,27
2020,Fiji,FJI,-,-,0,0,0,0,0,0,0,0,0,0,0,0,0,0,3199
2020,France,FRA,-,-,5,0,0,0,0,24,29,5,5,0,5,6,9,30,224
2020,Gabon,GAB,-,-,8,0,6,31,0,268,313,6,0,0,27,0,515,548,1569
2020,Gambia,GMB,-,-,150,82,34,632,0,604,1502,136,70,96,3143,11,1416,4872,17670
2020,Palestinian,PSE,-,-,492,1306,934,5285,957,37163,46137,472,1379,1025,7002,1053,40458,51389,113578
2020,United Kingdom of Great Britain and Northern Ireland,GBR,-,-,0,0,0,5,0,5,10,6,11,0,5,0,5,27,262
2020,Georgia,GEO,-,-,10555,18226,11416,80017,35335,3167,158716,10912,19287,12509,73516,22159,4707,143090,311292
2020,Germany,DEU,-,-,0,0,0,0,0,0,0,0,0,0,0,0,5,5,237
2020,Ghana,GHA,-,-,732,1134,954,3427,420,520,7187,127,1069,1325,3183,218,1092,7014,23941
2020,Guinea-Bissau,GNB,-,-,17,13,0,65,0,134,229,18,5,13,261,5,281,583,4351
2020,Greece,GRC,-,-,0,0,0,0,6,0,6,0,0,0,9,32,0,41,212
2020,Grenada,GRD,-,-,0,0,0,0,0,12,12,0,0,0,0,0,26,26,151
2020,Guatemala,GTM,-,-,199,285,215,1414,20,381,2514,203,306,216,2457,41,447,3670,197919
2020,Guinea,GIN,-,-,599,306,182,2356,19,6156,9618,580,260,638,6806,13,8918,17215,58358
2020,Guyana,GUY,-,-,0,0,0,0,0,30,30,5,0,0,0,0,36,41,975
2020,Haiti,HTI,-,-,118,479,266,5564,121,810,7358,179,439,237,7229,77,1561,9722,106004
2020,"China, Hong Kong SAR",HKG,-,-,0,0,0,0,0,23,23,0,0,0,0,0,48,48,502
2020,Honduras,HND,-,-,16243,25917,20410,77731,8472,5464,154237,13857,22203,17682,73847,7136,6311,141036,546048
2020,Croatia,HRV,-,-,0,7,26,890,250,3420,4593,0,7,21,1067,412,2623,4130,26810
2020,Hungary,HUN,-,-,26,14,45,227,64,114,490,60,55,20,302,136,145,718,5219
2020,Iceland,ISL,-,-,0,0,0,0,0,0,0,0,5,0,0,0,0,5,5
2020,Cote d'Ivoire,CIV,-,-,2835,4036,2975,12631,940,2566,25983,2708,3997,2959,12839,564,5231,28298,77166
2020,India,IND,-,-,290,399,217,4006,27,1775,6714,350,525,379,9603,172,4086,15115,82626
2020,Indonesia,IDN,-,-,23,35,0,1068,5,88,1219,24,32,5,43,6,103,213,18139
2020,Ireland,IRL,-,-,0,0,0,0,0,0,0,0,0,0,0,0,0,0,94
2020,Iran (Islamic Rep. of),IRN,-,-,2291,3873,3281,32094,2327,6629,50495,2268,4163,3739,50080,3128,12988,76366,212779
2020,Iraq,IRQ,-,-,18950,39910,27555,113709,12391,9580,222095,20231,42653,30979,140780,11252,19573,265468,1861133
2020,Israel,ISR,-,-,0,0,12,24,0,40,76,0,7,5,25,5,62,104,1036
2020,Italy,ITA,-,-,0,11,0,5,0,41,57,6,7,0,12,0,40,65,533
2020,Jamaica,JAM,-,-,7,0,0,124,0,142,273,9,0,5,263,0,185,462,4428
2020,Jordan,JOR,-,-,45,158,64,1362,23,353,2005,40,135,127,704,12,576,1594,8306
2020,Japan,JPN,-,-,0,0,9,5,0,0,14,0,0,14,0,0,11,25,161
2020,Kazakhstan,KAZ,-,-,8,35,12,130,31,260,476,17,29,20,167,7,453,693,8719
2020,Kenya,KEN,-,-,314,522,383,2196,182,265,3862,348,564,412,1819,152,419,3714,60381
2020,Kyrgyzstan,KGZ,-,-,26,62,28,144,9,180,449,29,45,27,150,5,220,476,5578
2020,Rep. of Korea,KOR,-,-,0,0,0,9,5,0,14,0,6,0,22,0,16,44,869
2020,Dem. People's Rep. of Korea,PRK,-,-,0,0,0,40,7,34,81,0,0,0,53,9,40,102,777
2020,Kuwait,KWT,-,-,9,43,64,109,0,290,515,5,35,69,104,5,631,849,2852
2020,Lao People's Dem. Rep.,LAO,-,-,0,0,0,0,7,0,7,0,0,0,30,12,15,57,7128
2020,Liberia,LBR,-,-,92,205,195,1086,55,78,1711,97,204,210,1434,57,135,2137,8287
2020,Libya,LBY,-,-,176,380,228,974,26,696,2480,183,431,227,2253,65,1591,4750,301223
2020,Saint Lucia,LCA,-,-,0,0,0,0,0,12,12,0,0,0,0,0,25,25,809
2020,Lebanon,LBN,-,-,273,453,333,4744,456,624,6883,250,589,422,1766,100,934,4061,18205
2020,Lesotho,LSO,-,-,6,0,0,20,0,0,26,0,0,0,0,0,0,0,44
2020,Liechtenstein,LIE,-,-,0,0,0,0,0,0,0,0,0,0,0,0,0,0,5
2020,Sri Lanka,LKA,-,-,192,326,202,1986,449,31646,34801,214,287,236,6131,410,32712,39990,182738
2020,Lithuania,LTU,-,-,0,0,0,0,0,0,0,0,0,0,5,0,17,22,136
2020,Luxembourg,LUX,-,-,0,0,0,5,0,0,5,0,0,0,0,0,0,0,5
2020,Latvia,LVA,-,-,0,5,0,0,0,0,5,0,0,0,12,0,5,17,235
2020,"China, Macao SAR",MAC,-,-,0,0,0,0,0,0,0,0,0,0,0,0,5,5,44
2020,Madagascar,MDG,-,-,0,0,0,14,0,89,103,0,7,0,0,0,187,194,606
2020,Martinique,MTQ,-,-,0,0,0,0,0,0,0,0,0,0,0,0,0,0,5
2020,Mauritania,MRT,-,-,253,3807,3817,6430,811,747,15865,297,3994,3758,6209,935,1635,16828,47183
2020,North Macedonia,MKD,-,-,81,130,113,545,35,193,1097,72,154,108,465,45,346,1190,3301
2020,Rep. of Moldova,MDA,-,-,76,96,79,382,17,497,1147,89,138,63,387,12,979,1668,7716
2020,Maldives,MDV,-,-,0,0,5,0,0,0,5,0,0,0,0,0,7,7,101
2020,Mexico,MEX,-,-,236,367,239,2195,0,197,3234,264,370,269,3342,0,339,4584,127126
2020,Marshall Islands,MHL,-,-,0,0,0,0,0,16,16,0,0,0,0,0,34,34,57
2020,Mali,MLI,-,-,11165,19783,13025,33676,2888,188027,268564,10972,19715,12537,23488,2821,150770,220303,508681
2020,Malaysia,MYS,-,-,0,5,5,17,0,127,154,5,7,0,22,0,269,303,22532
2020,Malawi,MWI,-,-,14,28,22,445,0,38,547,12,25,22,1403,20,62,1544,2682
2020,Mongolia,MNG,-,-,53,60,21,232,20,315,701,50,69,32,154,16,496,817,6412
2020,Morocco,MAR,-,-,118,105,39,724,20,1631,2637,122,103,74,1203,20,3254,4776,13108
2020,Mozambique,MOZ,-,-,134,253,156,467,54,5,1069,143,244,150,359,29,17,942,676793
2020,Malta,MLT,-,-,0,0,0,0,0,0,0,0,0,0,0,0,0,0,15
2020,Montenegro,MNE,-,-,11,21,21,156,19,24,252,17,28,22,124,11,13,215,1164
2020,Mauritius,MUS,-,-,0,5,0,19,0,35,59,5,0,5,16,0,84,110,514
2020,Myanmar,MMR,-,-,108554,137636,90787,347484,26151,38270,748882,109146,142294,96561,349196,28619,32918,758734,1513923
2020,Namibia,NAM,-,-,5,0,0,17,0,238,260,0,5,0,13,0,495,513,1298
2020,Nepal,NPL,-,-,6,0,0,120,0,419,545,5,6,5,312,0,948,1276,18188
2020,Netherlands (Kingdom of the),NLD,-,-,13,0,0,7,0,5,25,6,5,0,5,0,0,16,134
2020,Niger,NER,-,-,10887,25433,11477,32707,4132,189,84825,9533,21952,9659,28722,3498,388,73752,355740
2020,Nicaragua,NIC,-,-,76,124,74,854,22,2711,3861,102,121,84,1746,16,3336,5405,72451
2020,Nigeria,NGA,-,-,29368,49669,22054,76478,5871,1387995,1571435,28446,47900,20596,64089,5705,1236044,1402780,3036479
2020,Niue,NIU,-,-,0,0,0,0,0,0,0,0,0,0,0,0,0,0,25
2020,Norway,NOR,-,-,0,0,0,0,0,0,0,9,0,0,0,0,0,9,20
2020,Nauru,NRU,-,-,0,0,0,0,0,0,0,0,0,0,0,0,0,0,21
2020,New Zealand,NZL,-,-,0,0,0,0,0,0,0,0,0,0,8,0,0,8,67
2020,Oman,OMN,-,-,0,5,0,8,0,7,20,0,0,5,0,0,20,25,1091
2020,Pakistan,PAK,-,-,16368,19884,10945,43220,4186,4101,98704,17699,23251,12596,57431,5621,15594,132192,296342
2020,Panama,PAN,-,-,23,0,0,0,0,43,66,30,0,0,5,0,52,87,385
2020,Paraguay,PRY,-,-,0,10,0,15,0,245,270,0,0,5,22,0,300,327,987
2020,Peru,PER,-,-,32,30,0,402,85,2424,2973,36,0,38,430,97,2989,3590,513770
2020,Philippines,PHL,-,-,12,12,11,139,6,76893,77073,9,28,5,49,0,74117,74208,285293
2020,Papua New Guinea,PNG,-,-,0,0,0,0,0,0,0,0,0,0,0,0,0,0,15160
2020,Poland,POL,-,-,0,0,5,34,133,73,245,0,0,6,121,327,111,565,1962
2020,Portugal,PRT,-,-,7,0,0,0,0,0,7,0,0,0,7,0,0,7,387
2020,Qatar,QAT,-,-,0,0,0,0,0,5,5,0,0,0,5,0,8,13,71
2020,Romania,ROU,-,-,5,36,31,194,32,91,389,22,31,30,232,73,78,466,5063
2020,South Africa,ZAF,-,-,38,79,51,309,11,102,590,19,82,45,194,11,190,541,3710
2020,Russian Federation,RUS,-,-,1042,2362,1618,6514,650,5776,17962,1117,2599,1734,6046,430,8228,20154,97141
2020,Rwanda,RWA,-,-,2719,5612,4960,15146,921,105213,134571,2992,5722,4989,16866,1374,104159,136102,286205
2020,El Salvador,SLV,-,-,388,572,399,3565,67,42416,47407,425,647,516,5790,74,39047,46499,286908
2020,Saudi Arabia,SAU,-,-,16,41,15,134,0,122,328,19,27,40,174,0,178,438,3278
2020,Serbia and Kosovo: S/RES/1244 (1999),SRB,-,-,1164,1502,1549,7266,2292,1418,15191,1248,1549,1597,8220,2186,2247,17047,250238
2020,Senegal,SEN,-,-,130,668,562,1902,320,1422,5004,145,639,625,3943,308,2798,8458,29772
2020,Seychelles,SYC,-,-,0,0,0,0,0,0,0,0,0,0,0,0,5,5,15
2020,Singapore,SGP,-,-,0,0,0,0,0,0,0,0,0,8,0,0,9,17,111
2020,Sierra Leone,SLE,-,-,200,391,327,1873,104,451,3346,208,372,336,2985,110,969,4980,14118
2020,Solomon Islands,SLB,-,-,0,0,0,6,0,0,6,0,0,0,7,0,0,7,304
2020,Somalia,SOM,-,-,427881,398344,228213,780131,28763,5303,1868635,449259,414167,229479,761980,29155,8852,1892892,3833714
2020,Spain,ESP,-,-,0,6,12,5,0,5,28,0,0,21,5,7,0,33,346
2020,Viet Nam,VNM,-,-,63,116,100,725,228,1206,2438,83,129,101,1063,302,2628,4306,326236
2020,Saint Kitts and Nevis,KNA,-,-,0,0,0,0,0,5,5,0,0,0,0,0,8,8,72
2020,Sao Tome and Principe,STP,-,-,0,5,0,11,0,0,16,0,0,0,7,0,0,7,51
2020,Sudan,SDN,-,-,67887,89651,62154,179381,14409,1445357,1858839,69989,91858,63127,149609,12305,1112520,1499408,3410204
2020,Suriname,SUR,-,-,0,0,0,0,0,41,41,0,0,0,0,0,39,39,163
2020,South Sudan,SSD,-,-,157987,294793,190535,460812,44560,33,1148720,161099,301588,208558,345408,27281,81,1044015,4043953
2020,Slovakia,SVK,-,-,0,0,0,26,19,67,112,0,0,0,43,35,80,158,1577
2020,Slovenia,SVN,-,-,0,0,0,0,0,0,0,0,0,0,0,6,0,6,22
2020,Eswatini,SWZ,-,-,0,0,0,28,0,0,28,0,0,18,25,0,10,53,279
2020,Sweden,SWE,-,-,0,8,0,0,0,0,8,0,0,0,0,0,5,5,43
2020,Switzerland,CHE,-,-,0,0,0,0,0,0,0,0,0,0,0,0,0,0,21
2020,Syrian Arab Rep.,SYR,-,-,425234,600446,378231,1440559,104418,17223,2966111,438389,645510,430685,1786858,93695,32889,3428026,13519788
2020,United Rep. of Tanzania,TZA,-,-,70,30,25,306,0,152,583,48,80,18,774,0,202,1122,2624
2020,Turks and Caicos Islands,TCA,-,-,5,0,0,0,0,0,5,0,0,0,0,0,0,0,19
2020,Thailand,THA,-,-,0,5,0,81,0,34,120,0,0,12,52,0,76,140,3934
2020,Tajikistan,TJK,-,-,174,261,122,579,16,177,1329,204,255,133,826,14,277,1709,4678
2020,Turkmenistan,TKM,-,-,14,20,21,84,0,23,162,15,29,16,81,0,43,184,1083
2020,Timor-Leste,TLS,-,-,0,0,0,0,0,0,0,0,0,0,7,0,6,13,335
2020,Togo,TGO,-,-,126,305,333,1481,123,249,2617,140,314,266,2666,202,621,4209,11034
2020,Tonga,TON,-,-,0,0,0,0,0,0,0,0,0,0,0,0,0,0,762
2020,Trinidad and Tobago,TTO,-,-,0,0,0,10,0,57,67,0,0,0,10,0,101,111,1102
2020,Tunisia,TUN,-,-,39,48,31,263,7,329,717,46,34,26,585,12,814,1517,4476
2020,Türkiye,TUR,-,-,1803,3466,2960,19463,2758,6146,36596,1900,3761,3119,32391,2808,11479,55458,138274
2020,United Arab Emirates,ARE,-,-,5,7,5,14,0,5,36,0,8,0,21,0,8,37,362
2020,Uganda,UGA,-,-,178,316,186,2278,39,1199901,1202898,163,249,207,5131,91,1152732,1158573,2370504
2020,Ukraine,UKR,-,-,151,260,169,1117,265,1321716,1323678,158,299,155,988,128,1040744,1042472,2410587
2020,Uruguay,URY,-,-,0,0,0,5,0,104,109,7,0,0,10,0,126,143,450
2020,United States of America,USA,-,-,607,220,100,70,10,185,1192,640,272,101,96,23,180,1312,2847
2020,Uzbekistan,UZB,-,-,15,19,27,157,14,671,903,17,46,26,135,7,1024,1255,8283
2020,Vanuatu,VUT,-,-,0,0,0,0,0,0,0,0,0,0,0,0,0,0,158
2020,Holy See,VAT,-,-,0,0,0,0,0,0,0,0,0,0,0,0,0,0,12
2020,Saint Vincent and the Grenadines,VCT,-,-,0,0,0,0,0,7,7,0,0,0,5,0,14,19,780
2020,Venezuela (Bolivarian Republic of),VEN,-,-,117207,145835,169826,1100280,74519,214438,1822105,108069,140273,148943,975798,64684,209010,1646777,5996996
2020,Samoa,WSM,-,-,0,0,0,0,0,0,0,0,0,0,0,0,5,5,133
2020,Western Sahara,ESH,-,-,0,0,0,24,0,135,159,0,0,0,92,0,302,394,117968
2020,Yemen,YEM,-,-,281767,403183,402541,891318,80915,838,2060562,241709,443421,402842,825909,81130,2195,1997206,4069343
2020,Zambia,ZMB,-,-,0,5,25,171,0,21,222,0,0,5,106,0,38,149,732
2020,Zimbabwe,ZWE,-,-,94,311,484,7928,117,257,9191,100,323,425,7956,148,407,9359,23321
2020,Stateless,XXA,-,-,141358,112674,66176,407205,38773,281056,1047242,148050,131916,61517,326284,43937,307135,1018839,3045317
2020,Tibetan,TIB,-,-,0,0,0,0,0,6897,6897,0,0,0,7,0,5649,5656,12568
2020,Anguilla,AIA,-,-,0,0,0,0,0,0,0,0,0,0,0,0,0,0,5
2020,Guadeloupe,GLP,-,-,0,0,0,0,0,0,0,0,0,0,0,0,0,0,86
2020,Curacao ,CUW,-,-,0,0,0,0,0,0,0,0,0,0,0,0,0,0,35
2020,Unknown ,UNK,-,-,3192,2956,2285,12658,679,13019,34789,3331,3303,2843,22279,992,17672,50420,327323
2021,Afghanistan,AFG,-,-,580700,658485,478530,1332616,128756,18196,3197283,590640,675840,518799,1469392,157696,126727,3539094,7022010
2021,Albania,ALB,-,-,144,323,218,1201,49,830,2765,199,346,220,1294,60,1127,3246,42178
2021,Algeria,DZA,-,-,98,152,74,731,21,180,1256,126,161,130,2415,59,1207,4098,12907
2021,Andorra,AND,-,-,0,0,0,0,0,0,0,0,0,0,0,0,0,0,5
2021,Angola,AGO,-,-,1417,2598,1803,5751,590,195,12354,1458,2484,1863,4835,1032,221,11893,43887
2021,Antigua and Barbuda,ATG,-,-,0,0,0,22,0,0,22,0,0,7,11,0,0,18,160
2021,Egypt,EGY,-,-,272,528,392,1416,120,272,3000,222,549,392,2877,103,4551,8694,48596
2021,Argentina,ARG,-,-,41,10,5,103,0,15,174,26,9,10,126,8,22,201,1903
2021,Armenia,ARM,-,-,143,261,180,1483,384,393,2844,171,300,252,1619,287,463,3092,21546
2021,Australia,AUS,-,-,0,12,0,0,0,0,12,0,0,6,0,0,0,6,37
2021,Austria,AUT,-,-,0,5,0,0,0,0,5,5,0,0,0,0,0,5,28
2021,Azerbaijan,AZE,-,-,224,451,308,2368,564,278,4193,245,544,413,2396,380,388,4366,699552
2021,Bahrain,BHR,-,-,0,9,12,15,5,0,41,15,6,5,87,5,5,123,553
2021,Barbados,BRB,-,-,5,15,0,60,0,0,80,0,13,5,34,0,0,52,356
2021,Burundi,BDI,-,-,33388,37741,25804,82052,4529,284,183798,33005,38101,26453,103593,4386,350,205888,400138
2021,Belgium,BEL,-,-,5,0,0,7,5,0,17,0,0,0,8,0,0,8,123
2021,Benin,BEN,-,-,26,11,16,149,0,36,238,15,18,15,303,5,85,441,2112
2021,Bangladesh,BGD,-,-,67,138,80,899,38,150,1372,58,147,117,26905,121,9603,36951,263524
2021,Bahamas,BHS,-,-,27,45,33,233,0,24,362,30,47,33,183,0,20,313,1394
2021,Bhutan,BTN,-,-,125,370,346,1764,352,0,2957,126,387,417,1976,533,0,3439,7189
2021,Burkina Faso,BFA,-,-,128037,230161,131199,327670,32354,62,849483,129835,235454,135190,232793,28259,315,761846,1618849
2021,Belarus,BLR,-,-,10,34,33,208,22,783,1090,11,36,38,220,24,1210,1539,11431
2021,Bolivia (Plurinational State of),BOL,-,-,6,30,18,113,6,0,173,11,11,10,114,11,5,162,2379
2021,Botswana,BWA,-,-,0,0,5,65,0,0,70,0,9,5,27,0,0,41,335
2021,Brazil,BRA,-,-,1976,281,36,192,5,13722,16212,2080,320,21,247,0,13128,15796,54990
2021,Brunei Darussalam,BRN,-,-,0,0,0,0,0,0,0,0,0,0,0,0,0,0,5
2021,Bosnia and Herzegovina,BIH,-,-,104,177,102,836,260,47280,48759,112,144,102,690,183,49219,50450,116306
2021,Bulgaria,BGR,-,-,0,9,0,32,8,0,49,0,5,0,39,34,0,78,800
2021,Belize,BLZ,-,-,5,19,0,10,0,0,34,16,13,10,19,0,0,58,450
2021,Cambodia,KHM,-,-,17,14,42,262,14,0,349,16,30,30,241,29,0,346,12965
2021,Canada,CAN,-,-,0,0,17,7,0,0,24,0,0,14,5,0,0,19,186
2021,Central African Rep.,CAF,-,-,51384,97445,57890,172605,12657,415094,807075,51671,96757,56137,135328,11067,276749,627709,1446016
2021,Cayman Islands,CYM,-,-,0,0,0,0,0,0,0,0,0,0,0,0,0,0,5
2021,Chad,TCD,-,-,798,1379,842,2717,248,51,6035,804,1351,823,3197,226,126,6527,532945
2021,China,CHN,-,-,165,182,111,2710,160,374,3702,182,215,150,3517,224,420,4708,288708
2021,Chile,CHL,-,-,3736,129,18,194,43,29,4149,3665,108,12,183,69,21,4058,10045
2021,Cameroon,CMR,-,-,4884,9144,5340,22955,1774,789,44886,4951,8994,5046,20181,1117,1284,41573,1080788
2021,Congo,COG,-,-,107,238,565,5234,130,95,6369,56,281,504,7548,173,110,8672,161562
2021,Dem. Rep. of the Congo,COD,-,-,74702,106305,74398,230049,15156,1857,502467,75585,106460,75231,229807,12200,1850,501133,6479683
2021,Comoros,COM,-,-,0,10,5,174,0,17,206,0,0,7,369,0,21,397,3503
2021,Colombia,COL,-,-,78377,286831,385096,2112814,407383,127438,3397939,83011,299325,401892,2208104,426202,133766,3552300,8208726
2021,Costa Rica,CRI,-,-,45,15,21,32,0,950,1063,39,16,5,49,0,913,1022,3087
2021,Cuba,CUB,-,-,245,505,302,9940,247,164,11403,185,490,358,17615,281,188,19117,96788
2021,Cabo Verde,CPV,-,-,0,5,5,0,0,0,10,0,0,0,5,0,0,5,283
2021,Cyprus,CYP,-,-,0,0,0,0,0,0,0,0,0,0,5,0,0,5,20
2021,Czechia,CZE,-,-,7,5,7,58,124,0,201,0,13,0,79,202,0,294,919
2021,Denmark,DNK,-,-,0,0,0,0,0,0,0,0,0,0,8,0,0,8,33
2021,Djibouti,DJI,-,-,6,30,6,86,10,49,187,5,26,28,127,0,41,227,4902
2021,Dominica,DMA,-,-,0,0,0,5,0,0,5,0,5,0,10,0,0,15,178
2021,Dominican Rep.,DOM,-,-,5,34,21,649,5,11,725,0,33,23,577,5,6,644,5277
2021,Ecuador,ECU,-,-,55,51,25,169,0,20,320,60,52,31,213,5,28,389,29111
2021,Equatorial Guinea,GNQ,-,-,0,5,5,14,0,0,24,0,0,5,5,8,0,18,403
2021,Eritrea,ERI,-,-,15663,29753,24625,123449,7420,3406,204316,16650,30635,27543,137100,8278,8807,229013,599637
2021,Estonia,EST,-,-,0,0,0,0,0,0,0,0,0,0,16,0,0,16,319
2021,Ethiopia,ETH,-,-,9961,14063,10111,61775,2680,506,99096,10706,15116,11244,118283,3663,678,159690,4023479
2021,French Guiana,GUF,-,-,33,5,0,0,0,0,38,34,0,0,0,0,0,34,96
2021,Fiji,FJI,-,-,0,0,0,0,0,0,0,0,0,0,6,0,0,6,3411
2021,Finland,FIN,-,-,0,0,0,0,0,0,0,0,0,0,0,0,0,0,5
2021,France,FRA,-,-,5,8,6,17,0,5,41,5,16,5,21,0,0,47,317
2021,Gabon,GAB,-,-,7,5,6,46,0,24,88,0,10,0,42,0,21,73,1522
2021,Gambia,GMB,-,-,159,82,40,646,0,81,1008,133,75,104,2191,11,1047,3561,16832
2021,Palestinian,PSE,-,-,484,1129,907,4893,942,35840,44195,444,1168,1061,6923,1025,37398,48019,114335
2021,United Kingdom of Great Britain and Northern Ireland,GBR,-,-,5,8,0,5,0,0,18,14,11,0,12,0,0,37,378
2021,Georgia,GEO,-,-,9611,18259,12542,79859,36442,1633,158346,10122,19152,13661,74527,22704,1218,141384,316558
2021,Germany,DEU,-,-,0,0,0,15,0,0,15,0,0,0,14,0,0,14,307
2021,Ghana,GHA,-,-,152,951,1341,3761,438,158,6801,111,988,1349,3317,230,714,6709,23445
2021,Guinea-Bissau,GNB,-,-,22,5,5,61,0,5,98,10,6,19,223,5,72,335,4585
2021,Greece,GRC,-,-,5,0,0,0,6,0,11,0,0,5,13,33,0,51,258
2021,Grenada,GRD,-,-,0,0,0,0,0,0,0,0,0,0,9,0,0,9,149
2021,Guatemala,GTM,-,-,22162,32437,31419,135585,18699,40,240342,20889,31355,41187,165737,17583,46,276797,742971
2021,Guinea,GIN,-,-,779,407,178,2801,18,591,4774,754,335,933,6438,16,1438,9914,61001
2021,Guyana,GUY,-,-,15,6,5,37,0,0,63,8,10,10,26,0,0,54,7033
2021,Haiti,HTI,-,-,571,1652,848,24411,151,80,27713,533,1722,836,35281,108,107,38587,184404
2021,"China, Hong Kong SAR",HKG,-,-,0,14,0,5,0,84,103,0,7,0,15,0,84,106,912
2021,Honduras,HND,-,-,16367,29316,21392,93610,8317,183,169185,17973,25227,21348,99103,7670,226,171547,517697
2021,Croatia,HRV,-,-,0,0,12,103,57,111,283,0,0,0,82,101,95,278,18348
2021,Hungary,HUN,-,-,47,43,29,277,67,58,521,83,72,26,337,144,57,719,5261
2021,Iceland,ISL,-,-,0,0,0,0,0,0,0,0,0,0,7,0,0,7,12
2021,Cote d'Ivoire,CIV,-,-,2134,3360,2368,11393,825,522,20602,2147,3279,2385,12084,470,1006,21371,72700
2021,India,IND,-,-,267,413,230,4163,105,249,5427,310,531,397,9885,203,1394,12720,92845
2021,Indonesia,IDN,-,-,24,41,5,1082,5,9,1166,19,35,5,49,5,8,121,20110
2021,Ireland,IRL,-,-,0,0,12,5,0,0,17,0,7,0,5,0,0,12,146
2021,Iran (Islamic Rep. of),IRN,-,-,1930,3573,3002,29845,2469,1702,42521,1850,3830,3438,46095,3309,3201,61723,212221
2021,Iraq,IRQ,-,-,15076,36545,28102,110950,12578,3148,206399,15907,39120,31121,139032,11154,6787,243121,1815365
2021,Israel,ISR,-,-,0,5,0,52,0,5,62,6,14,5,57,0,5,87,1260
2021,Italy,ITA,-,-,6,16,5,33,0,0,60,5,7,5,33,0,0,50,700
2021,Jamaica,JAM,-,-,12,9,16,234,7,21,299,8,14,12,387,5,11,437,4724
2021,Jordan,JOR,-,-,53,157,79,1420,54,143,1906,73,151,122,828,12,237,1423,9649
2021,Japan,JPN,-,-,0,0,8,11,0,0,19,0,0,5,9,0,0,14,173
2021,Kazakhstan,KAZ,-,-,6,27,15,139,28,123,338,10,32,15,159,6,152,374,9123
2021,Kenya,KEN,-,-,230,578,373,2205,184,74,3644,275,598,406,1870,172,61,3382,171411
2021,Kyrgyzstan,KGZ,-,-,21,46,31,127,13,110,348,20,38,27,129,5,86,305,5820
2021,Kiribati,KIR,-,-,0,0,0,0,0,0,0,0,0,0,0,0,0,0,5
2021,Rep. of Korea,KOR,-,-,0,5,5,21,5,10,46,0,5,5,25,0,0,35,1010
2021,Dem. People's Rep. of Korea,PRK,-,-,0,0,0,43,7,5,55,0,0,0,59,11,10,80,636
2021,Kuwait,KWT,-,-,5,71,50,168,5,15,314,6,42,85,129,0,20,282,3564
2021,Lao People's Dem. Rep.,LAO,-,-,0,0,0,0,6,0,6,0,0,0,29,13,0,42,7252
2021,Liberia,LBR,-,-,122,209,195,1151,61,30,1768,92,183,219,1443,72,63,2072,8520
2021,Libya,LBY,-,-,160,446,255,1076,28,185,2150,198,484,265,2262,76,577,3862,203904
2021,Saint Lucia,LCA,-,-,0,0,5,16,0,0,21,0,0,5,6,0,0,11,548
2021,Lebanon,LBN,-,-,1071,1166,575,7773,752,286,11623,1119,1247,587,2487,180,471,6091,26597
2021,Lesotho,LSO,-,-,7,0,0,18,0,0,25,0,0,0,5,0,0,5,47
2021,Liechtenstein,LIE,-,-,0,0,0,0,0,5,5,0,0,0,0,0,0,0,10
2021,Sri Lanka,LKA,-,-,162,320,242,1956,464,30232,33376,170,308,247,5773,479,28937,35914,172104
2021,Lithuania,LTU,-,-,0,0,7,0,0,0,7,0,0,0,5,0,7,12,168
2021,Latvia,LVA,-,-,0,0,0,10,0,0,10,0,0,0,11,0,0,11,242
2021,"China, Macao SAR",MAC,-,-,0,0,0,0,0,0,0,0,0,0,0,0,0,0,34
2021,Madagascar,MDG,-,-,0,0,0,34,0,10,44,5,10,5,14,0,0,34,808
2021,Mauritania,MRT,-,-,1205,3427,2736,6733,794,85,14980,1309,3498,2628,6473,917,130,14955,47984
2021,North Macedonia,MKD,-,-,214,330,202,1038,56,120,1960,255,398,251,988,74,173,2139,5945
2021,Rep. of Moldova,MDA,-,-,143,212,155,738,53,358,1659,168,228,166,653,51,299,1565,9071
2021,Maldives,MDV,-,-,0,0,5,0,0,0,5,0,0,0,0,0,0,0,101
2021,Mexico,MEX,-,-,229,426,283,2633,37,33,3641,267,411,298,3837,23,51,4887,134339
2021,Marshall Islands,MHL,-,-,0,0,0,0,0,0,0,0,0,0,0,0,0,0,7
2021,Mali,MLI,-,-,11852,23186,15490,39540,3235,192832,286135,11704,22810,15057,29017,3190,158587,240365,557815
2021,Malaysia,MYS,-,-,0,0,16,23,0,0,39,0,10,0,37,0,5,52,22037
2021,Malawi,MWI,-,-,10,30,19,418,0,0,477,11,20,20,1320,30,0,1401,2531
2021,Mongolia,MNG,-,-,32,64,28,222,22,131,499,46,65,44,151,16,109,431,7186
2021,Morocco,MAR,-,-,124,124,42,761,26,348,1425,137,133,75,1210,19,2223,3797,18116
2021,Mozambique,MOZ,-,-,140,253,157,481,56,5,1092,157,239,161,359,29,5,950,753768
2021,Malta,MLT,-,-,0,0,0,0,0,0,0,0,0,0,0,0,0,0,12
2021,Montenegro,MNE,-,-,32,23,25,169,19,20,288,20,32,22,130,12,18,234,1432
2021,Mauritius,MUS,-,-,10,5,0,22,0,9,46,5,5,0,24,0,0,34,549
2021,Myanmar,MMR,-,-,115179,146547,97091,368709,28413,166540,922479,118459,151203,104905,371752,30232,165488,942039,1892414
2021,Namibia,NAM,-,-,10,9,0,50,0,0,69,0,11,5,27,0,0,43,1396
2021,Nepal,NPL,-,-,5,0,5,94,0,61,165,5,15,8,233,0,160,421,18721
2021,Netherlands (Kingdom of the),NLD,-,-,9,0,6,7,0,0,22,5,15,0,10,0,0,30,151
2021,Niger,NER,-,-,26126,45473,24580,57686,5095,40,159000,21112,36221,19400,43119,5128,139,125119,285908
2021,Nicaragua,NIC,-,-,837,3029,2457,67753,9355,89,83520,604,2297,2943,58374,7195,90,71503,204450
2021,Nigeria,NGA,-,-,28777,56020,26324,82902,6582,2325,202930,27616,53531,24062,66378,6299,3320,181206,3551699
2021,Niue,NIU,-,-,0,0,0,0,0,0,0,0,0,0,0,0,0,0,11
2021,Norway,NOR,-,-,5,0,0,0,0,0,5,0,5,0,7,0,0,12,28
2021,Nauru,NRU,-,-,0,0,0,0,0,0,0,0,0,0,0,0,0,0,21
2021,New Zealand,NZL,-,-,0,5,0,13,0,0,18,0,0,0,20,6,0,26,102
2021,Oman,OMN,-,-,24,30,86,322,5,0,467,23,26,85,194,6,0,334,907
2021,Pakistan,PAK,-,-,16297,19883,11027,43358,4235,456,95256,17592,23202,12686,55389,5708,14210,128787,1519140
2021,Panama,PAN,-,-,68,15,5,0,0,7076,7164,65,23,5,12,0,7445,7550,15151
2021,Paraguay,PRY,-,-,5,5,5,29,0,9,53,0,0,0,24,10,0,34,1227
2021,Peru,PER,-,-,87,43,33,503,100,279,1045,88,47,48,493,109,304,1089,512920
2021,Philippines,PHL,-,-,6,16,5,191,8,53711,53937,9,24,15,121,0,51586,51755,294911
2021,Papua New Guinea,PNG,-,-,0,0,0,0,0,0,0,0,0,0,0,0,0,0,25143
2021,Poland,POL,-,-,7,6,6,56,139,0,214,5,10,5,103,335,0,458,1943
2021,Portugal,PRT,-,-,0,14,0,12,0,0,26,0,0,0,18,0,0,18,465
2021,Qatar,QAT,-,-,0,0,0,0,0,0,0,0,0,0,5,0,0,5,82
2021,Romania,ROU,-,-,17,35,16,171,29,38,306,16,25,36,208,72,39,396,5869
2021,South Africa,ZAF,-,-,41,86,69,306,22,13,537,24,61,59,214,10,17,385,4205
2021,Russian Federation,RUS,-,-,779,2009,1537,6041,638,1349,12353,815,2264,1643,5554,431,1572,12279,111506
2021,Rwanda,RWA,-,-,25162,33328,24026,51595,3056,234,137401,22069,34670,25150,51586,4026,229,137730,293471
2021,El Salvador,SLV,-,-,1030,1846,1157,11257,271,40518,56079,1130,2013,1407,24048,506,35361,64465,332761
2021,Saudi Arabia,SAU,-,-,10,60,26,187,0,45,328,27,19,44,244,0,24,358,3740
2021,Serbia and Kosovo: S/RES/1244 (1999),SRB,-,-,1173,1473,1495,6559,2125,404,13229,1245,1520,1582,7528,1973,616,14464,250404
2021,Senegal,SEN,-,-,118,664,581,2000,323,130,3816,125,660,711,4817,321,837,7471,32595
2021,Seychelles,SYC,-,-,0,0,0,0,0,0,0,0,0,0,0,0,0,0,14
2021,Singapore,SGP,-,-,0,0,5,0,0,0,5,0,0,7,0,0,0,7,134
2021,Sierra Leone,SLE,-,-,142,240,204,1250,16,75,1927,174,173,228,1918,20,289,2802,12305
2021,Solomon Islands,SLB,-,-,0,0,0,6,0,0,6,0,0,0,7,0,0,7,1352
2021,Somalia,SOM,-,-,432316,398587,227544,781999,28036,2723,1871205,454846,415483,230877,718657,29108,4450,1853421,3803830
2021,Spain,ESP,-,-,0,0,18,17,5,5,45,0,0,23,36,0,5,64,478
2021,Viet Nam,VNM,-,-,67,122,96,802,253,34,1374,68,131,107,1058,317,84,1765,328150
2021,Saint Kitts and Nevis,KNA,-,-,0,0,0,0,0,0,0,0,0,0,6,0,0,6,79
2021,Sao Tome and Principe,STP,-,-,0,0,0,6,0,0,6,0,0,0,0,0,0,0,31
2021,Sudan,SDN,-,-,170185,364796,264135,915148,103412,306,1817982,184288,455646,269001,1023419,122586,806,2055746,3937345
2021,Suriname,SUR,-,-,0,0,0,5,0,5,10,0,0,0,0,0,10,10,140
2021,South Sudan,SSD,-,-,155456,311958,208247,506956,48550,14,1231181,158038,317666,227411,399825,32362,38,1135340,4635106
2021,Slovakia,SVK,-,-,9,11,5,47,17,15,104,15,13,0,69,35,26,158,1597
2021,Slovenia,SVN,-,-,0,0,0,0,0,0,0,0,5,0,0,6,0,11,27
2021,Eswatini,SWZ,-,-,0,0,5,38,0,0,43,0,0,16,30,0,0,46,255
2021,Sweden,SWE,-,-,0,0,0,9,0,0,9,0,0,0,0,0,0,0,52
2021,Switzerland,CHE,-,-,0,0,0,0,0,0,0,0,0,0,0,0,0,0,21
2021,Syrian Arab Rep.,SYR,-,-,407575,641988,378133,1476947,108962,6104,3019709,432981,681236,411840,1838313,97771,23454,3485595,13857059
2021,United Rep. of Tanzania,TZA,-,-,65,73,26,360,5,40,569,49,96,46,747,5,46,989,2626
2021,Turks and Caicos Islands,TCA,-,-,5,0,0,0,0,0,5,0,0,0,0,0,0,0,19
2021,Thailand,THA,-,-,0,5,0,79,5,10,99,0,0,6,54,6,5,71,3411
2021,Tajikistan,TJK,-,-,133,198,110,475,17,155,1088,131,208,103,705,18,202,1367,4435
2021,Turkmenistan,TKM,-,-,15,15,17,69,0,26,142,11,23,16,76,5,27,158,1285
2021,Timor-Leste,TLS,-,-,0,0,0,0,0,0,0,0,0,0,7,0,0,7,379
2021,Togo,TGO,-,-,108,280,292,1511,138,51,2380,109,260,284,2486,227,245,3611,10994
2021,Tonga,TON,-,-,0,0,0,0,0,0,0,0,0,0,0,0,0,0,844
2021,Trinidad and Tobago,TTO,-,-,0,5,0,25,0,2469,2499,0,11,0,26,0,2148,2185,5988
2021,Tunisia,TUN,-,-,40,52,41,308,11,270,722,54,55,50,742,14,1472,2387,6222
2021,Türkiye,TUR,-,-,1968,4526,3098,17904,2266,2443,32205,2114,4791,3389,32769,2685,5492,51240,151468
2021,United Arab Emirates,ARE,-,-,0,5,19,7,0,0,31,0,13,5,28,0,0,46,375
2021,Uganda,UGA,-,-,230,363,265,2692,39,1238912,1242501,237,290,269,5255,109,1190294,1196454,2448627
2021,Ukraine,UKR,-,-,212,459,260,1880,394,1231473,1234678,238,508,285,1570,198,1049162,1051961,2325793
2021,Uruguay,URY,-,-,20,0,6,14,0,5,45,23,5,0,16,0,0,44,693
2021,United States of America,USA,-,-,337,183,94,103,21,22,760,302,196,88,139,11,16,752,2094
2021,Uzbekistan,UZB,-,-,15,14,22,130,15,226,422,5,41,20,97,7,489,659,7960
2021,Vanuatu,VUT,-,-,0,0,0,0,0,0,0,0,0,0,0,0,0,0,172
2021,Holy See,VAT,-,-,0,0,0,0,0,0,0,0,0,0,0,0,0,0,12
2021,Saint Vincent and the Grenadines,VCT,-,-,0,5,0,23,5,0,33,0,0,0,15,0,0,15,552
2021,Venezuela (Bolivarian Republic of),VEN,-,-,105738,171573,188693,1453404,89645,705659,2714712,112307,179262,183571,1293851,70495,666904,2506390,6966720
2021,Samoa,WSM,-,-,0,0,0,0,0,0,0,0,0,0,0,0,0,0,165
2021,Western Sahara,ESH,-,-,5,0,0,27,0,0,32,0,0,0,88,0,0,88,117735
2021,Yemen,YEM,-,-,344866,389100,431416,955199,86697,313,2207591,344837,432166,431764,841455,86984,1407,2138613,4361839
2021,Zambia,ZMB,-,-,0,0,18,178,0,0,196,0,0,10,102,0,0,112,749
2021,Zimbabwe,ZWE,-,-,74,230,434,7654,158,21,8571,83,223,357,7700,186,20,8569,21765
2021,Stateless,XXA,-,-,138861,116450,68862,427030,40117,278699,1070019,143588,134216,63972,342497,43654,270585,998512,3143085
2021,Tibetan,TIB,-,-,0,0,0,0,0,6897,6897,0,0,0,0,0,5643,5643,12593
2021,Anguilla,AIA,-,-,0,0,0,0,0,0,0,0,0,0,0,0,0,0,5
2021,Aruba,ABW,-,-,0,0,0,0,0,3163,3163,0,0,0,0,0,2837,2837,6000
2021,Guadeloupe,GLP,-,-,0,0,0,0,0,0,0,0,0,0,0,0,0,0,88
2021,Curacao ,CUW,-,-,0,0,0,0,0,2979,2979,0,0,0,0,0,2247,2247,5261
2021,Unknown ,UNK,-,-,3207,3544,2585,16223,1534,105042,132135,3291,3855,3101,26628,1609,110764,149248,357646
2022,Afghanistan,AFG,-,-,766188,945375,684775,1999126,184505,148675,4728644,780769,976994,746835,2211297,240836,240520,5197251,10179284
2022,Albania,ALB,-,-,156,317,281,1576,57,6678,9065,176,377,250,1802,92,6664,9361,55253
2022,Algeria,DZA,-,-,131,186,110,988,38,1980,3433,143,207,195,3898,70,4311,8824,16733
2022,Andorra,AND,-,-,0,0,5,0,0,0,5,0,0,0,0,0,0,0,10
2022,Angola,AGO,-,-,1092,2121,1622,5027,426,3585,13873,1105,2034,1611,4166,768,3901,13585,41589
2022,Antigua and Barbuda,ATG,-,-,0,0,5,25,0,0,30,0,6,8,26,0,0,40,116
2022,Egypt,EGY,-,-,192,500,469,1820,174,1138,4293,161,490,550,3871,229,11641,16942,52323
2022,Argentina,ARG,-,-,79,36,15,150,5,427,712,48,39,23,212,5,445,772,2454
2022,Armenia,ARM,-,-,168,328,272,2671,575,4210,8224,180,410,402,3158,414,4481,9045,28323
2022,Australia,AUS,-,-,0,0,0,5,0,0,5,0,0,0,11,0,5,16,56
2022,Austria,AUT,-,-,0,5,5,0,0,5,15,0,0,0,0,0,8,8,58
2022,Azerbaijan,AZE,-,-,177,373,305,2726,632,3035,7248,167,444,375,3339,428,3751,8504,706532
2022,Bahrain,BHR,-,-,5,10,11,11,5,16,58,0,0,12,77,5,11,105,460
2022,Barbados,BRB,-,-,6,22,30,188,0,0,246,5,19,16,91,0,0,131,457
2022,Burundi,BDI,-,-,32672,37218,25027,79993,4456,3284,182650,32569,37845,25849,100262,4496,4026,205047,391579
2022,Belgium,BEL,-,-,0,7,0,12,0,5,24,0,0,5,6,0,5,16,114
2022,Benin,BEN,-,-,36,27,16,176,5,198,458,24,22,29,397,10,273,755,2223
2022,Bangladesh,BGD,-,-,83,160,178,1381,89,2227,4118,63,174,248,14840,164,25725,41214,260114
2022,Bahamas,BHS,-,-,44,131,70,506,7,0,758,45,105,70,355,0,0,575,1991
2022,Bhutan,BTN,-,-,125,370,346,1769,352,37,2999,126,387,417,1989,533,133,3585,7162
2022,Burkina Faso,BFA,-,-,157442,274499,159168,391766,41704,560,1025139,157535,275895,161370,286014,35288,890,916992,1947869
2022,Belarus,BLR,-,-,36,101,65,584,72,1055,1913,33,103,55,622,52,1238,2103,19964
2022,Bolivia (Plurinational State of),BOL,-,-,8,39,18,249,10,133,457,13,41,21,254,24,94,447,2900
2022,Botswana,BWA,-,-,5,31,6,251,0,8,301,15,18,18,127,0,0,178,795
2022,Brazil,BRA,-,-,3803,2442,1092,8457,16,1163,16973,3975,2608,1147,9596,52,1123,18501,55501
2022,Brunei Darussalam,BRN,-,-,0,0,0,0,0,0,0,0,0,0,0,0,0,0,14
2022,Bosnia and Herzegovina,BIH,-,-,77,158,96,808,258,50648,52045,87,132,97,702,181,52812,54011,115727
2022,Bulgaria,BGR,-,-,5,8,12,80,10,148,263,0,19,5,103,32,312,471,1151
2022,Belize,BLZ,-,-,10,27,18,76,0,0,131,14,45,24,71,0,0,154,546
2022,Cambodia,KHM,-,-,12,23,33,266,16,5254,5604,13,25,22,226,17,5564,5867,12667
2022,Canada,CAN,-,-,5,11,11,24,0,5,56,0,21,7,30,0,23,81,404
2022,Central African Rep.,CAF,-,-,48572,97732,60266,176767,13140,265883,662360,49051,97516,58402,136650,11468,255575,608662,1280529
2022,Cayman Islands,CYM,-,-,0,0,0,0,0,0,0,0,0,0,0,0,0,0,5
2022,Chad,TCD,-,-,726,1381,894,2886,256,1335,7478,735,1392,929,3817,251,2215,9339,502857
2022,China,CHN,-,-,156,339,371,8452,652,6451,16421,147,379,384,10900,530,8586,20926,277722
2022,Chile,CHL,-,-,4503,350,44,311,48,271,5527,4445,321,31,312,76,275,5460,15340
2022,Cameroon,CMR,-,-,7849,14050,8096,31302,2665,16270,80232,7832,13787,7554,24849,1570,16606,72198,1158373
2022,Congo,COG,-,-,2032,2916,1709,10935,2129,3099,22820,1980,2849,1811,11048,1505,3271,22464,49839
2022,Dem. Rep. of the Congo,COD,-,-,82229,107226,74890,226609,14973,20222,526149,82995,107399,75567,221974,12423,21535,521893,6624836
2022,Comoros,COM,-,-,0,0,0,10,0,787,797,5,0,0,24,0,1141,1170,2692
2022,Colombia,COL,-,-,73499,290377,398943,2323606,469074,667123,4222622,66706,263799,362421,2121543,427120,643812,3885401,8752074
2022,Costa Rica,CRI,-,-,143,184,158,1045,349,59,1938,133,217,159,1035,294,55,1893,4605
2022,Cuba,CUB,-,-,825,1775,1139,32176,921,2716,39552,770,1865,1379,45929,882,4334,55159,400828
2022,Cabo Verde,CPV,-,-,0,5,0,15,0,5,25,0,0,0,19,0,0,19,276
2022,Cyprus,CYP,-,-,0,0,0,7,0,0,7,0,0,0,6,0,0,6,31
2022,Czechia,CZE,-,-,6,21,16,99,137,0,279,5,31,10,142,201,10,399,827
2022,Denmark,DNK,-,-,0,0,0,0,0,0,0,0,5,0,0,0,0,5,35
2022,Djibouti,DJI,-,-,6,50,10,797,10,613,1486,6,26,25,227,0,510,794,3533
2022,Dominica,DMA,-,-,0,10,0,23,0,6,39,0,0,0,10,0,5,15,219
2022,Dominican Rep.,DOM,-,-,14,52,45,1377,15,219,1722,24,42,46,2053,16,193,2374,7720
2022,Ecuador,ECU,-,-,707,1429,702,6800,30,977,10645,726,1433,806,6347,55,1142,10509,68893
2022,Equatorial Guinea,GNQ,-,-,5,0,23,15,0,73,116,0,7,5,36,7,68,123,443
2022,Eritrea,ERI,-,-,14472,30253,25537,127972,8488,8747,215469,15013,31324,28030,133096,8959,18103,234525,596700
2022,Estonia,EST,-,-,0,0,0,5,0,0,5,0,0,0,5,0,0,5,101
2022,Ethiopia,ETH,-,-,10590,14949,10874,62393,2682,2619,104107,11465,16145,11702,94508,3769,3557,141146,3601657
2022,French Guiana,GUF,-,-,55,12,0,0,0,0,67,57,14,0,0,0,0,71,166
2022,Fiji,FJI,-,-,0,0,0,14,0,0,14,0,5,0,28,0,0,33,3653
2022,Finland,FIN,-,-,5,0,0,0,0,0,5,0,0,5,0,0,0,5,15
2022,France,FRA,-,-,11,19,10,19,0,5,64,17,22,0,32,6,20,97,470
2022,Micronesia (Federated States of),FSM,-,-,0,0,0,0,0,0,0,0,0,0,0,0,0,0,5
2022,Gabon,GAB,-,-,5,15,10,68,0,375,473,0,10,5,80,0,289,384,1487
2022,Gambia,GMB,-,-,132,69,34,611,5,476,1327,117,56,91,1805,11,2024,4104,15515
2022,Palestinian,PSE,-,-,548,1165,945,4951,882,38375,46866,609,1159,1007,6909,964,43825,54473,118526
2022,United Kingdom of Great Britain and Northern Ireland,GBR,-,-,0,10,26,31,0,28,95,0,13,0,42,5,38,98,645
2022,Georgia,GEO,-,-,9694,18516,13783,82296,37203,7211,168703,10257,19567,14838,80047,22949,6221,153879,335375
2022,Germany,DEU,-,-,0,0,7,22,0,15,44,0,12,0,29,0,35,76,696
2022,Ghana,GHA,-,-,167,688,1408,3660,491,483,6897,118,717,1380,3857,280,1393,7745,23716
2022,Guinea-Bissau,GNB,-,-,15,0,10,60,0,534,619,11,6,27,245,0,945,1234,4321
2022,Greece,GRC,-,-,5,5,5,16,7,5,43,5,5,5,22,32,10,79,319
2022,Grenada,GRD,-,-,0,0,0,7,0,0,7,0,0,0,11,0,0,11,167
2022,Guatemala,GTM,-,-,23259,38887,35393,162026,18803,3969,282337,21942,38202,45935,189743,17733,2583,316138,736903
2022,Guinea,GIN,-,-,824,309,209,2518,28,15666,19554,772,272,729,5960,37,13728,21498,60545
2022,Guyana,GUY,-,-,18,14,11,117,0,2534,2694,20,13,16,113,0,1714,1876,5377
2022,Haiti,HTI,-,-,718,2188,1317,32917,369,3696,41205,674,2148,1261,45238,252,4270,53843,240172
2022,"China, Hong Kong SAR",HKG,-,-,0,11,10,60,0,0,81,0,8,24,60,0,0,92,1162
2022,Honduras,HND,-,-,18968,37118,26376,125383,8492,7237,223574,20746,33538,26865,124141,7910,5879,219079,562999
2022,Croatia,HRV,-,-,0,0,15,108,32,41,196,0,0,0,96,96,30,222,17665
2022,Hungary,HUN,-,-,30,110,99,671,128,24,1062,29,103,111,707,172,80,1202,3280
2022,Iceland,ISL,-,-,0,0,0,0,0,0,0,0,0,0,8,0,0,8,13
2022,Cote d'Ivoire,CIV,-,-,608,563,398,4328,112,10727,16736,512,505,454,5584,85,6547,13687,47257
2022,India,IND,-,-,205,721,522,6825,222,961,9456,274,919,788,25655,406,11978,40020,121717
2022,Indonesia,IDN,-,-,22,57,31,1317,41,10,1478,18,51,27,379,6,5,486,22900
2022,Ireland,IRL,-,-,0,5,0,11,0,0,16,0,10,5,5,0,8,28,202
2022,Iran (Islamic Rep. of),IRN,-,-,1350,2634,2427,23777,2573,4281,37042,1346,2856,2754,32021,3277,7322,49576,191519
2022,Iraq,IRQ,-,-,12610,28411,24119,94551,11850,10397,181938,13254,30253,26468,117431,10675,16944,215025,1714646
2022,Israel,ISR,-,-,5,30,10,77,10,59,191,11,18,17,147,8,170,371,1713
2022,Italy,ITA,-,-,5,22,47,54,5,30,163,8,24,34,67,5,41,179,821
2022,Jamaica,JAM,-,-,5,27,33,625,24,22,736,0,17,43,824,12,77,973,5213
2022,Jordan,JOR,-,-,66,187,182,2042,61,230,2768,73,192,193,1781,46,512,2797,10366
2022,Japan,JPN,-,-,0,6,10,20,0,0,36,0,5,8,24,0,0,37,216
2022,Kazakhstan,KAZ,-,-,19,69,38,526,65,775,1492,25,80,37,568,23,733,1466,11842
2022,Kenya,KEN,-,-,166,620,352,2399,206,195329,199072,181,657,392,1951,175,206379,209735,419175
2022,Kyrgyzstan,KGZ,-,-,25,73,58,529,19,470,1174,38,71,72,690,13,453,1337,7699
2022,Kiribati,KIR,-,-,0,0,0,0,0,0,0,0,0,0,0,0,0,0,30
2022,Rep. of Korea,KOR,-,-,0,0,0,104,0,10,114,0,5,0,45,0,0,50,1007
2022,Dem. People's Rep. of Korea,PRK,-,-,0,0,10,67,10,14,101,0,0,5,49,11,19,84,387
2022,Kuwait,KWT,-,-,13,82,66,193,10,276,640,11,49,73,171,0,432,736,4882
2022,Lao People's Dem. Rep.,LAO,-,-,0,0,0,7,16,2935,2958,0,0,0,49,21,3430,3500,7067
2022,Liberia,LBR,-,-,134,192,190,1215,70,314,2115,111,169,201,1445,85,596,2607,8519
2022,Libya,LBY,-,-,146,426,288,1082,41,1141,3124,178,477,316,2358,83,2436,5848,185571
2022,Saint Lucia,LCA,-,-,0,10,0,33,0,5,48,0,0,0,38,0,5,43,216
2022,Lebanon,LBN,-,-,2085,2084,825,9972,949,578,16493,2234,2270,928,4413,303,1101,11249,35635
2022,Lesotho,LSO,-,-,7,0,0,10,0,0,17,6,0,0,0,0,0,6,42
2022,Liechtenstein,LIE,-,-,0,0,0,0,0,0,0,0,0,0,0,0,5,5,10
2022,Sri Lanka,LKA,-,-,126,292,270,2108,561,42830,46187,137,296,256,5933,604,50645,57871,171797
2022,Lithuania,LTU,-,-,0,0,0,25,0,9,34,0,0,0,21,5,22,48,205
2022,Luxembourg,LUX,-,-,0,0,0,5,0,0,5,0,0,0,0,0,0,0,5
2022,Latvia,LVA,-,-,0,0,0,24,0,22,46,0,0,0,29,0,30,59,274
2022,"China, Macao SAR",MAC,-,-,0,0,0,0,0,0,0,0,0,5,0,0,0,5,58
2022,Madagascar,MDG,-,-,0,0,0,54,5,256,315,10,0,0,25,0,206,241,1079
2022,Mauritania,MRT,-,-,1266,2939,2550,6359,716,2685,16515,1320,3032,2330,6091,843,6297,19913,45474
2022,North Macedonia,MKD,-,-,279,485,287,1289,75,610,3025,322,497,301,1295,104,614,3133,7044
2022,Rep. of Moldova,MDA,-,-,171,259,204,1379,104,1105,3222,184,250,177,1561,76,1176,3424,11799
2022,Maldives,MDV,-,-,0,0,5,0,0,5,10,0,0,0,0,0,0,0,104
2022,Mexico,MEX,-,-,982,3580,2490,22958,383,978,31371,1033,3757,2665,24475,508,1275,33713,406486
2022,Mali,MLI,-,-,15674,27132,17039,45805,3810,5998,115458,15436,26471,16466,35437,3633,6244,103687,619017
2022,Malaysia,MYS,-,-,0,10,10,73,0,18,111,0,5,0,70,0,14,89,21119
2022,Malawi,MWI,-,-,14,31,11,288,0,5,349,10,21,21,636,7,5,700,1668
2022,Mongolia,MNG,-,-,41,88,44,441,20,587,1221,42,68,61,494,21,497,1183,7350
2022,Morocco,MAR,-,-,113,122,46,811,33,2716,3841,142,130,107,1691,28,14019,16117,29961
2022,Mozambique,MOZ,-,-,149,256,192,384,51,549971,551003,183,243,172,298,29,478798,479723,1037478
2022,Malta,MLT,-,-,0,0,0,0,0,0,0,0,0,0,0,0,0,0,10
2022,Montenegro,MNE,-,-,38,31,28,210,22,127,456,27,31,32,257,12,107,466,1561
2022,Mauritius,MUS,-,-,0,5,0,40,0,45,90,0,10,0,24,0,44,78,636
2022,Myanmar,MMR,-,-,119896,153608,100637,376916,30841,571222,1353120,125065,159343,108467,379937,33014,580466,1386292,2806981
2022,Namibia,NAM,-,-,6,13,18,80,0,0,117,7,12,12,33,0,0,64,1796
2022,Nepal,NPL,-,-,0,5,24,400,10,637,1076,5,18,27,1652,20,935,2657,20855
2022,Netherlands (Kingdom of the),NLD,-,-,6,6,15,40,0,0,67,10,15,0,20,0,0,45,196
2022,Niger,NER,-,-,30943,66515,40945,97161,7854,187,243605,24785,57172,34204,66562,10872,512,194107,439106
2022,Nicaragua,NIC,-,-,2320,6969,4901,116410,14397,2913,147910,2365,5534,4801,101628,11664,4192,130184,359532
2022,Nigeria,NGA,-,-,27071,55088,29523,87562,6836,1810722,2016802,26255,53193,26935,65506,7892,1496074,1675855,3761370
2022,Niue,NIU,-,-,0,0,0,0,0,0,0,0,0,0,0,0,0,0,18
2022,Norway,NOR,-,-,0,0,0,0,0,0,0,0,0,0,5,0,0,5,20
2022,Nauru,NRU,-,-,0,0,0,0,0,0,0,0,0,0,0,0,0,0,24
2022,New Zealand,NZL,-,-,0,0,0,0,0,0,0,0,0,0,9,0,0,9,80
2022,Oman,OMN,-,-,0,10,0,7,0,0,17,0,5,15,0,0,0,20,153
2022,Pakistan,PAK,-,-,9836,11678,7057,26990,2656,1592,59809,9033,12195,6495,32079,3005,24688,87495,1433303
2022,Panama,PAN,-,-,211,59,10,41,0,59,380,185,47,0,68,0,77,377,97976
2022,Paraguay,PRY,-,-,10,5,12,44,0,397,468,5,0,16,37,7,471,536,1366
2022,Peru,PER,-,-,288,282,239,2064,144,7175,10192,264,318,209,2183,165,6748,9887,649229
2022,Philippines,PHL,-,-,0,36,10,419,45,50234,50744,7,17,11,247,41,48149,48472,287345
2022,Palau,PLW,-,-,0,0,0,5,0,0,5,0,0,0,0,0,0,0,5
2022,Papua New Guinea,PNG,-,-,0,0,0,0,0,0,0,0,0,0,0,0,0,0,91854
2022,Poland,POL,-,-,5,11,19,245,150,84,514,0,15,12,270,335,148,780,2010
2022,Portugal,PRT,-,-,6,14,10,41,0,31,102,0,14,0,35,0,16,65,498
2022,Qatar,QAT,-,-,0,0,0,0,0,0,0,0,5,0,5,0,0,10,168
2022,Romania,ROU,-,-,91,235,218,1099,35,993,2671,108,287,232,1302,77,1623,3629,10139
2022,South Africa,ZAF,-,-,31,126,108,511,30,106,912,37,102,119,367,35,125,785,4258
2022,Russian Federation,RUS,-,-,976,2466,1718,10296,1237,22625,39318,983,2626,1969,11379,703,23596,41256,173438
2022,Rwanda,RWA,-,-,18299,31184,23921,58240,3866,2971,138481,19208,33031,23783,53620,5060,2905,137607,291969
2022,El Salvador,SLV,-,-,1787,6284,4727,33656,360,95139,141953,1785,6810,5311,33686,444,81451,129487,417460
2022,Saudi Arabia,SAU,-,-,5,44,43,237,0,48,377,5,34,56,319,0,50,464,4504
2022,Serbia and Kosovo: S/RES/1244 (1999),SRB,-,-,1217,1485,1520,6428,2078,9571,22299,1304,1524,1575,7513,1969,9907,23792,247607
2022,Senegal,SEN,-,-,228,358,349,1551,123,2310,4919,237,416,449,5770,169,4219,11260,30445
2022,Seychelles,SYC,-,-,0,0,0,0,0,0,0,0,0,0,0,0,0,0,14
2022,Singapore,SGP,-,-,0,0,10,0,0,0,10,0,0,5,5,0,0,10,150
2022,Sierra Leone,SLE,-,-,129,200,207,1228,17,1107,2888,116,197,204,1942,35,1970,4464,13053
2022,Solomon Islands,SLB,-,-,0,0,0,0,0,0,0,0,0,0,11,0,0,11,1604
2022,Somalia,SOM,-,-,430035,400627,229637,788392,28445,52761,1929897,452298,418438,232610,720671,28994,56985,1909996,3900961
2022,Spain,ESP,-,-,5,16,42,33,0,5,101,5,30,5,67,0,20,127,514
2022,Viet Nam,VNM,-,-,102,183,149,1813,279,3917,6443,94,204,170,2059,402,4822,7751,27982
2022,Saint Kitts and Nevis,KNA,-,-,0,0,0,5,0,0,5,0,0,5,5,0,0,10,54
2022,Sao Tome and Principe,STP,-,-,0,0,0,6,0,5,11,0,0,0,0,0,0,0,34
2022,Sudan,SDN,-,-,262525,474844,318252,900582,106335,10457,2072995,322732,586339,391870,918273,119651,28421,2367286,4478387
2022,Suriname,SUR,-,-,5,0,0,0,0,21,26,7,0,0,12,0,20,39,178
2022,South Sudan,SSD,-,-,166221,290411,201125,489633,48477,227,1196094,169304,298334,224169,378842,32185,448,1103282,4146790
2022,Slovakia,SVK,-,-,13,29,33,152,24,69,320,16,40,27,199,42,61,385,772
2022,Slovenia,SVN,-,-,0,0,0,0,0,0,0,0,0,0,5,7,0,12,38
2022,Eswatini,SWZ,-,-,6,0,0,51,0,0,57,0,5,16,46,0,0,67,261
2022,Sweden,SWE,-,-,0,11,0,15,0,0,26,5,5,0,5,0,5,20,105
2022,Switzerland,CHE,-,-,0,0,0,0,0,0,0,0,0,0,0,0,8,8,35
2022,Syrian Arab Rep.,SYR,-,-,417801,582912,383059,1390896,106481,35330,2916479,442754,617138,420600,1699202,94954,78930,3353578,28698670
2022,United Rep. of Tanzania,TZA,-,-,57,72,34,422,5,84,674,36,66,51,615,5,100,873,2733
2022,Turks and Caicos Islands,TCA,-,-,5,0,0,11,0,0,16,0,0,0,0,0,0,0,30
2022,Thailand,THA,-,-,0,5,10,117,0,30,162,0,0,18,52,10,11,91,3404
2022,Tajikistan,TJK,-,-,116,194,120,677,12,226,1345,126,204,142,1392,20,363,2247,6589
2022,Turkmenistan,TKM,-,-,5,22,13,163,6,209,418,10,14,27,437,6,601,1095,3098
2022,Timor-Leste,TLS,-,-,0,0,0,0,0,0,0,0,0,0,14,0,0,14,696
2022,Togo,TGO,-,-,80,262,268,1602,153,545,2910,72,242,289,2662,278,1114,4657,10742
2022,Tonga,TON,-,-,0,0,5,0,0,0,5,0,0,0,0,0,0,0,1338
2022,Trinidad and Tobago,TTO,-,-,358,43,14,73,5,15,508,355,48,5,78,0,20,506,7138
2022,Tunisia,TUN,-,-,50,67,49,455,9,976,1606,74,68,65,1411,22,4822,6462,10629
2022,Türkiye,TUR,-,-,2326,3766,2340,16063,2107,8783,35385,2495,4306,2971,43248,2529,24951,80500,175114
2022,United Arab Emirates,ARE,-,-,0,11,23,31,0,0,65,0,8,18,43,0,12,81,786
2022,Uganda,UGA,-,-,280,392,346,2935,58,1317166,1321177,276,379,337,4758,103,1265473,1271326,2601278
2022,Ukraine,UKR,-,-,267195,452035,429583,2598354,837457,1528204,6112828,241501,421284,389291,1595164,556643,781216,3985099,12180077
2022,Uruguay,URY,-,-,54,0,0,54,0,65,173,76,7,6,36,0,60,185,646
2022,United States of America,USA,-,-,321,234,92,125,14,88,874,365,259,82,194,30,144,1074,3431
2022,Uzbekistan,UZB,-,-,76,111,126,706,53,517,1589,55,172,122,1554,23,969,2895,13044
2022,Vanuatu,VUT,-,-,0,7,6,9,0,0,22,0,5,0,0,0,0,5,710
2022,Holy See,VAT,-,-,0,0,0,0,0,0,0,0,0,0,0,0,0,0,17
2022,Saint Vincent and the Grenadines,VCT,-,-,0,5,0,53,5,0,63,0,0,0,37,0,0,37,256
2022,Venezuela (Bolivarian Republic of),VEN,-,-,216080,269570,377676,2164403,157743,563933,3749405,214783,264498,345377,1843934,132382,499572,3300546,9977101
2022,Samoa,WSM,-,-,0,0,0,0,0,0,0,0,0,0,0,0,0,0,403
2022,Western Sahara,ESH,-,-,0,0,0,20,0,198,218,0,0,0,97,0,669,766,91791
2022,Yemen,YEM,-,-,1767,2936,2452,10960,888,2228609,2247612,1799,3131,2839,25633,1162,2298830,2333394,4595201
2022,Zambia,ZMB,-,-,0,0,10,142,0,6,158,0,5,5,109,0,7,126,771
2022,Zimbabwe,ZWE,-,-,97,228,320,3999,103,103,4850,82,215,252,4795,105,74,5523,14655
2022,Stateless,XXA,-,-,134448,117016,72909,425425,44139,300697,1094634,138828,134752,68648,342038,47364,290704,1022334,3189760
2022,Tibetan,TIB,-,-,0,0,0,0,0,6897,6897,0,0,0,5,0,5648,5653,12565
2022,Anguilla,AIA,-,-,0,0,0,0,0,5,5,0,0,0,0,0,0,0,10
2022,Aruba,ABW,-,-,0,0,0,0,0,901,901,0,0,0,0,0,799,799,1707
2022,Guadeloupe,GLP,-,-,5,6,0,21,0,0,32,0,7,0,9,0,0,16,145
2022,Curacao ,CUW,-,-,0,0,0,0,0,901,901,0,0,0,0,0,799,799,1740
2022,Unknown ,UNK,-,-,2166,2262,1813,9394,959,113229,129823,2205,2428,2108,16852,1168,117681,142442,614090
